A person swimming pool ocean body water Â  Lacked goggles Â  prior versions iOS Swims facing left scree	ğŸŠ	1
This version Woman Dancing emoji Light Skin Tone applied displayed Pale Skin Tone supported platforms	ğŸ’ƒğŸ»	1
Black Large Square approved Unicode 5.1 2008 added Emoji 1.0 2015 Copy paste emoji Copy	â¬›	1
A mobile phone Â  referred cellular cell phone countries The artwork emoji varies platform Apple Google S	ğŸ“±	1
The flag Â  Jamaica letters Â  JM Â  platforms The Flag Jamaica emoji sequence Regional Indica	ğŸ‡¯ğŸ‡²	1
This version Baby emoji Dark Skin Tone applied displayed Black Skin Tone supported platforms Copy	ğŸ‘¶ğŸ¿	1
This version Person Raising Hand emoji Dark Skin Tone applied displayed Black Skin Tone supported pla	ğŸ™‹ğŸ¿	1
This version Boy emoji Medium dark Skin Tone applied displayed Dark Brown Skin Tone supported platfor	ğŸ‘¦ğŸ¾	1
The flag French Southern Territories letters Â  TF Â  platforms The Flag French Southern Territories emoji	ğŸ‡¹ğŸ‡«	1
A gust Â  air representing fast movement person object left character Â  Can combination e	ğŸ’¨	1
A memorandum piece paper Â  written Â  communication formal settings Displayed piece paper written p	ğŸ“	1
A ripe yellow banana ready eaten Enjoyed humans monkeys alike Tends grown warm tropical climates Banana app	ğŸŒ	1
A green face shown pursed lipsed Â  vomit Used literally sickness display Â  disgust Differs  	ğŸ¤¢	1
A horse head shown facing forward left screen platforms Looks right Facebook Distinct horse emo	ğŸ´	1
A widely misunderstood emoji lack consistency platforms A railway railroad Â  car carriage generally pul	ğŸšƒ	1
A high speed train designed cover long distances high speed High speed Train approved Unicode 6.0 2010 n	ğŸš„	1
The flag Panama letters Â  PA Â  platforms The Flag Panama emoji sequence Regional Indicato	ğŸ‡µğŸ‡¦	1
An eagle soaring sky Also national embled United States Eagle approved Unicode 9.0 2016 add	ğŸ¦…	1
Has eyes closed sticking tongue Face With Stuck Tongue Closed Eyes approved Unicode 6.0 2010 na	ğŸ˜	1
A snowman shown Â  falling snow This old text glyph includes emoji presentation iOS 9.1 Are looking	â˜ƒ	1
The flag Â  Mozambique letters Â  MZ Â  platforms The Flag Mozambique emoji sequence Regional  	ğŸ‡²ğŸ‡¿	1
This version Open Hands emoji Medium dark Skin Tone applied displayed Dark Brown Skin Tone supported  	ğŸ‘ğŸ¾	1
Generic profile person Often interface design represent user Bust Silhouette approved Unicode 6.0	ğŸ‘¤	1
This version Vulcan Salute emoji Medium Skin Tone applied displayed Moderate Brown Skin Tone supporte	ğŸ––ğŸ½	1
The flag Â  Maldives letters Â  MV Â  platforms The Flag Maldives emoji sequence Regional Indi	ğŸ‡²ğŸ‡»	1
Two open hands representing openness Sometimes hug display jazz hands Open Hands approved Unicode 6	ğŸ‘	1
A point star pale yellow color Generally visual flair astronomical purposes White Medium Star approved	â­	1
An emoji face blowing Â  kiss Â  officially called â€œ Face Throwing A Kiss â€ One eye open winking A heart shown leaving  	ğŸ˜˜	1
A smiling face smiling eyes rosy cheeks Showing true sense happiness This emoji smiles mouth closed makes	ğŸ˜Š	1
Headphones listen music forms audio podcasts Â  Most platforms display emoji large ear headphones	ğŸ§	1
The flag Â  Norway letters Â  NO Â  platforms The Flag Norway emoji sequence Regional Indicato	ğŸ‡³ğŸ‡´	1
A video game emoji Â  shown major platforms console Â  gamepad D pad joysticks buttons Video Game approved Uni	ğŸ®	1
Stopwatch approved Unicode 6.0 2010 added Emoji 1.0 2015 Copy paste emoji Copy	â±	1
This emoji eyes mouth Represents silence emoji silent Imagine things mouth Fa	ğŸ˜¶	1
The flag Paraguay letters Â  PY Â  platforms The Flag Paraguay emoji sequence Regional Indi	ğŸ‡µğŸ‡¾	1
An orange carrot shown raw green leaves attached Carrot approved Unicode 9.0 2016 added Emoji 3.0 2016 C	ğŸ¥•	1
The flag Bolivia letters Â  BO Â  platforms The Flag Bolivia emoji sequence Regional Indica	ğŸ‡§ğŸ‡´	1
This version Clapping Hands emoji Medium dark Skin Tone applied displayed Dark Brown Skin Tone suppor	ğŸ‘ğŸ¾	1
The flag Poland letters Â  PL Â  platforms The Flag Poland emoji sequence Regional Indicato	ğŸ‡µğŸ‡±	1
The flag Croatia letters Â  HR Â  platforms The Flag Croatia emoji sequence Regional Indica	ğŸ‡­ğŸ‡·	1
This version Woman Dancing emoji Medium dark Skin Tone applied displayed Dark Brown Skin Tone support	ğŸ’ƒğŸ¾	1
A bomb lit fuse This means soon explode Bomb approved Unicode 6.0 2010 added Emoji 1.0 2015  	ğŸ’£	1
A wolf shown Â  gray fur Â  black nose pointed ears platforms Appeared like Â  yellow brown dog iOS November 2016	ğŸº	1
Small Airplane approved Unicode 7.0 2014 added Emoji 1.0 2015 Copy paste emoji Copy	ğŸ›©	1
The flag Serbia letters Â  RS Â  platforms The Flag Serbia emoji sequence Regional Indicato	ğŸ‡·ğŸ‡¸	1
A revolving red light seen police car Often emergency circumstances addition siren making loud warning sound	ğŸš¨	1
The flag Â  Switzerland letters Â  CH Â  platforms The Flag Switzerland emoji sequence Regiona	ğŸ‡¨ğŸ‡­	1
Shows map country Japan country emoji map Other countries found globe  	ğŸ—¾	1
The flag Â  Sudan letters Â  SD Â  platforms The Flag Sudan emoji sequence Regional Indicator  	ğŸ‡¸ğŸ‡©	1
This version Horse Racing emoji Dark Skin Tone applied displayed Black Skin Tone supported platforms	ğŸ‡ğŸ¿	1
The flag Brazil letters Â  BR Â  platforms The Flag Brazil emoji sequence Regional Indicato	ğŸ‡§ğŸ‡·	1
Pleasantly content Happy Â  Feeling sense relief Â  situation convey calm content state mind R	ğŸ˜Œ	1
A face displayed wearing wide brimmed cowboy hat Shown yellow smiley non human appearance Cowboy Hat Face approved par	ğŸ¤ 	1
A cartoon style balloon represent spoken word comics Sometimes Â  communication apps Â  indicate person ty	ğŸ’¬	1
An open mailbox flag raised The flag Â  mailbox USA indicate Â  mail delivered m	ğŸ“¬	1
This Â  face Â  raised eyebrows open eyes open mouth Â  A mixture shock disappointment Anguished Face approved Unico	ğŸ˜§	1
This version Backhand Index Pointing Left emoji Medium Skin Tone applied displayed Moderate Brown Skin T	ğŸ‘ˆğŸ½	1
Bento â€“ Japanese combination rice vegetables meat packed box lunch Bento Box approved Unicode 6.0 20	ğŸ±	1
This pine decoration called Â  kadomatsu Japanese bamboo pine A kadomatsu placed Japanese homes	ğŸ	1
A Â  yellow sun kind smiling face Not typical smiling sun big grin sunglasses Sun With Face approved Uni	ğŸŒ	1
The flag Seychelles letters Â  SC Â  platforms The Flag Seychelles emoji sequence Regional  	ğŸ‡¸ğŸ‡¨	1
The flag Â  Nicaragua letters Â  NI Â  platforms The Flag Nicaragua emoji sequence Regional In	ğŸ‡³ğŸ‡®	1
Two women Â  standing smiling pink love heart floating air The Couple With Heart Woman Woman	ğŸ‘©â€â¤ï¸â€ğŸ‘©	1
A place coins notes money females The male equivalent wallet Purse approved Unicode  	ğŸ‘›	1
A Â  gun emoji precisely Â  pistol A Â  weapon potential cause great harm Displayed facing right left platforms iOS  	ğŸ”«	1
Spaghetti twirled fork bowl spaghetti bolognese Spaghetti approved Unicode 6.0 2010 added Em	ğŸ	1
A sneaker â€“ comfortable shoe sports tennis golf Â  fashion purposes Running Shoe approved Unicode  	ğŸ‘Ÿ	1
A person bowing deeply known Â  dogeza Japan Used express sincere apology Â  request large favour Many variations o	ğŸ™‡	1
The flag Â  Syria letters Â  SY Â  platforms The Flag Syria emoji sequence Regional Indicator  	ğŸ‡¸ğŸ‡¾	1
This version Person Getting Haircut emoji Medium light Skin Tone applied displayed Cream White Skin Tone	ğŸ’‡ğŸ¼	1
Prayer beads people religious traditions Prayer Beads approved Unicode 8.0 2015 added Emoji 1.0	ğŸ“¿	1
Baguette Bread approved Unicode 9.0 2016 added Emoji 3.0 2016 Copy paste emoji Copy New Â  iOS 10	ğŸ¥–	1
A button mouse variety desktop computers Apple displays emoji image Magic Mouse	ğŸ–±	1
The face dragon showing head Most platforms display green looking similar dinosaur Â  The dragon face emoji s	ğŸ²	1
This version Waving Hand emoji Medium dark Skin Tone applied displayed Dark Brown Skin Tone supported	ğŸ‘‹ğŸ¾	1
The flag Â  British Indian Ocean Territory Â  letters Â  IO Â  platforms The flag Diego Garcia The	ğŸ‡®ğŸ‡´	1
This version Raising Hands emoji Light Skin Tone applied displayed Pale Skin Tone supported platforms	ğŸ™ŒğŸ»	1
A symbol comics visual mediums indicating person dizzy This usually shown circle stars surrounding t	ğŸ’«	1
A person enjoying bath shower Differs Â  Bathtub Emoji person bathing â€œ having  	ğŸ›€	1
This version Person Frowning emoji Medium light Skin Tone applied displayed Cream White Skin Tone sup	ğŸ™ğŸ¼	1
A Â  dart board dart hitting center bullseye region Direct Hit approved Unicode 6.0 2010 added Emoji 1.0	ğŸ¯	1
The letters Â  OK shown enclosed Â  square Â  Meaning Okay denoting approval The opposite Squared NG Emoji OK Button approved	ğŸ†—	1
This version Folded Hands emoji Medium light Skin Tone applied displayed Cream White Skin Tone suppor	ğŸ™ğŸ¼	1
A music note emoji Â  denote song lyrics music related topics Displays eighth notes quavers British English c	ğŸµ	1
This version Backhand Index Pointing Left emoji Medium dark Skin Tone applied displayed Dark Brown Skin  	ğŸ‘ˆğŸ¾	1
This version Nose emoji Light Skin Tone applied displayed Pale Skin Tone supported platforms Copy	ğŸ‘ƒğŸ»	1
This version Person Wearing Turban emoji Dark Skin Tone applied displayed Black Skin Tone supported p	ğŸ‘³ğŸ¿	1
A classic reel reel film camera symbol movies films general May relation Emoji Movie Movie  	ğŸ¥	1
This version Person Frowning emoji Medium dark Skin Tone applied displayed Dark Brown Skin Tone suppo	ğŸ™ğŸ¾	1
A bow arrow sport archery May cupid Bow Arrow approved Unicode 8.0 2015 added	ğŸ¹	1
The flag Â  Tanzania letters Â  TZ Â  platforms The Flag Tanzania emoji sequence Regional Indi	ğŸ‡¹ğŸ‡¿	1
An uncooked potato baking larger meal Not confused roasted sweet potato Potato	ğŸ¥”	1
A building worship people faith religion Examples include church mosque synagogue A person shown  	ğŸ›	1
Two Â  women Â  holding hands likely relationship Two Women Holding Hands approved Unicode 6.0 2010	ğŸ‘­	1
A round black white ball game soccer known football world Soccer Ball approved  	âš½	1
The Â  Cancer astrological sign Zodiac This Zodiac Symbol represents Crab Cancer approved Unicode 1.1 1993 add	â™‹	1
Paintbrush approved Unicode 7.0 2014 â€œ Lower Left Paintbrush â€ added Emoji 1.0 2015 Copy paste	ğŸ–Œ	1
A cricket bat cricket ball shown May displayed wicket present Cricket approved Unicode 8.0 2015 u	ğŸ	1
An umbrella hooked handle open rain falling unlike umbrella raindrops Umbrella approved  	â˜‚	1
A mosque building place worship followes Islam Shown domed roof minaret Mosque approved Unicode 8	ğŸ•Œ	1
A stick figure icon man generally indicate male Â  restroom The female equivalent Womens Symbol emoji Men Room	ğŸš¹	1
A crab shown claws May relation zodiac symbol cancer Crab approved Unicode 8.0 2015 adde	ğŸ¦€	1
The flag Â  Ireland letters Â  IE Â  platforms The Flag Ireland emoji sequence Regional Indica	ğŸ‡®ğŸ‡ª	1
The flag Tristan da Cunha letters TA platforms Â  This flag Ascension Island Â  St. Helen	ğŸ‡¹ğŸ‡¦	1
Popcorn snack eaten cinema Sometimes referred popping corn Popcorn approved Unicode 8.0 2015	ğŸ¿	1
A white envelope sealed sticker seal red love heart Contains love letter Love Letter approved Unicode 6.0	ğŸ’Œ	1
The flag Peru letters Â  PE Â  platforms The Flag Peru emoji sequence Regional Indicator Sy	ğŸ‡µğŸ‡ª	1
The Â  Pisces astrological sign Zodiac This Zodiac Symbol represents Fish Pisces approved Unicode 1.1 1993 add	â™“	1
The Flag SÃ£o TomÃ© PrÃ­ncipe emoji sequence Regional Indicator Symbol LetÂ­ter S Regional Indicator Symbol LetÂ­ter  	ğŸ‡¸ğŸ‡¹	1
A bottle nipple teat feeding milk babies Baby Bottle approved Unicode 6.0 2010 added	ğŸ¼	1
A left facing speech bubble included Unicode 7.0 considered standard addition purposes emoji presentatio	ğŸ—¨	1
The flag Botswana letters Â  BW Â  platforms The Flag Botswana emoji sequence Regional Indi	ğŸ‡§ğŸ‡¼	1
A gem Â  appears blue screen presumably intended appear Â  similar shade diamond Gem Stone approved Uni	ğŸ’	1
A large cloud like shape commonly known Thought Bubble Used represent thinking thoughts commonly Â  comics di	ğŸ’­	1
A loaf bread Â  displayed appears prior slicing May creation sandwich Bread approved Unicode  	ğŸ	1
A larger version small orange diamond emoji Large Orange Diamond approved Unicode 6.0 2010 added Emoji 1.0  	ğŸ”¶	1
Two triangles pointing left Most commonly symbol Â  rewinding media video tapes CDs digital audio video	âª	1
A Â  face little bit happy Â  slight smile Â  Â  neutral Â  eyes Slightly Smiling Face approved Unicode 7.0 2014	ğŸ™‚	1
An unlocked open Â  padlock Â  real world Â  secure object symbol non secure page relating Â  SSL certifica	ğŸ”“	1
The flag Portugal letters Â  PT Â  platforms The Flag Portugal emoji sequence Regional Indi	ğŸ‡µğŸ‡¹	1
A notebook decorative cover Unless Apple device shows plain undecorated cover Notebook With Decor	ğŸ“”	1
A pole red white blue stripes Traditionally barbers place work May Â  parts Asia	ğŸ’ˆ	1
A sign indicating mobile phones turned Used Â  situations cinema live performance Displayed mobile ph	ğŸ“´	1
An undercover investigator Â  wearing hat magnifying glass closely inspect evidence This emoji originally	ğŸ•µ	1
Three eighth notes quavers British English represent music singing Sometimes inserted Â  Â  quoted Â  lyrics cl	ğŸ¶	1
This version Nail Polish emoji Medium light Skin Tone applied displayed Cream White Skin Tone support	ğŸ’…ğŸ¼	1
Firework emoji showing explosion colored light night sky number celebrations New Year Eve Colors va	ğŸ†	1
A house known home living Suitable couple larger family housemates Distinct  	ğŸ 	1
An emoji symbol white flower cherry blossom The Apple artwork contains Â  Japanese text inside translates mean â€œ W	ğŸ’®	1
A face sad neutral mouth Â  single drop sweat Face With Cold Sweat approved Unicode 6.0 2010 added  	ğŸ˜“	1
The flag India letters Â  IN Â  platforms The Flag India emoji sequence Regional Indicator  	ğŸ‡®ğŸ‡³	1
A heart shaped box tied ribbon May gift box box chocolates jewellery box Heart With Ribbon approved  	ğŸ’	1
The letters Â  NG shown enclosed Â  square Â  acronym words No Good The origin NG Â  refers Â  bloopers Â  shown  	ğŸ†–	1
A person snowboarding downhill ski resort Wearing clothing designed cold climates Snowboarder approved Unicode 6.0	ğŸ‚	1
The cat variant Smiling Face With Open Mouth Emoji Smiling Cat Face With Open Mouth approved Unicode 6.0 2010  	ğŸ˜º	1
Black Flag approved Unicode 7.0 2014 â€œ Waving Black Flag â€ added Emoji 1.0 2015 Copy paste thi	ğŸ´	1
A couch floor lamp Couch Lamp approved Unicode 7.0 2014 added Emoji 1.0 2015 Copy p	ğŸ›‹	1
Blue Circle approved Unicode 6.0 2010 â€œ Large Blue Circle â€ added Emoji 1.0 2015 Copy paste th	ğŸ”µ	1
Atom Symbol approved Unicode 4.1 2005 added Emoji 1.0 2015 Copy paste emoji Copy	âš›	1
A round cartoon style hole ground May context crawling hole shameful embarrassing situation Hol	ğŸ•³	1
The flag British Virgin Islands letters Â  VG Â  platforms The Flag British Virgin Islands emoji sequ	ğŸ‡»ğŸ‡¬	1
A red mask displayed Â  thick hairy eyebrows Â  long nose Goblin approved Unicode 6.0 2010 â€œ Japanes	ğŸ‘º	1
Spiral Calendar approved Unicode 7.0 2014 â€œ Spiral Calendar Pad â€ added Emoji 1.0 2015 Copy pa	ğŸ—“	1
A large rotating wheel found carnival fair Ferris Wheel approved Unicode 6.0 2010 added Emoji 1.0	ğŸ¡	1
The flag Â  Norfolk Island letters Â  NF Â  platforms The Flag Norfolk Island emoji sequence R	ğŸ‡³ğŸ‡«	1
A dizzy face looking sick confused spun circles times Difficult distinguish Â  Astonished Face Â 	ğŸ˜µ	1
The cat variant Â  Smirking Face Emoji Cat Face With Wry Smile approved Unicode 6.0 2010 added Emoji 1.0 20	ğŸ˜¼	1
A person long nose indicate telling lie Lying Face approved Unicode 9.0 2016 added Emoji  	ğŸ¤¥	1
SOS description Â  distress signal Morse Code Â  This emoji means SOS â€œ emergency â€ SOS Button approved Unicod	ğŸ†˜	1
The flag Â  Afghanistan letters AF platforms The Flag Afghanistan emoji sequence Regiona	ğŸ‡¦ğŸ‡«	1
An iteration Playboy Bunny Â  known Japan Bunny Girl Â  Usually depicted attractive woman Â  wearing bunny ears Â  bunny girl Â  	ğŸ‘¯	1
This version Oncoming Fist emoji Medium dark Skin Tone applied displayed Dark Brown Skin Tone support	ğŸ‘ŠğŸ¾	1
A type tree leaves turn orange brown Â  fall season fall autumn Deciduous Tree approved  	ğŸŒ³	1
This version Person Raising Hand emoji Light Skin Tone applied displayed Pale Skin Tone supported pla	ğŸ™‹ğŸ»	1
The word soon arrow pointing right SOON Arrow approved Unicode 6.0 2010 â€œ Soon W	ğŸ”œ	1
This version Person Rowing Boat emoji Medium light Skin Tone applied displayed Cream White Skin Tone  	ğŸš£ğŸ¼	1
A green book reads â€œ Vol 2 John Appleseed â€ Â  cover Apple artwork Green Book approved Unicode 6.0 2010	ğŸ“—	1
The cat variant Â  Face With Tears Of Joy Cat Face With Tears Joy approved Unicode 6.0 2010 added Emoji 1.0	ğŸ˜¹	1
A closed mailbox flag resting The lowered flag Â  mailbox USA indicate Â  mail de	ğŸ“ª	1
A stack books different colors Books approved Unicode 6.0 2010 added Emoji 1.0 2015 Copy paste	ğŸ“š	1
Cash money form dollar note bill Appears Â  1 note issued United States Dollars USD Apple artwork Cupertin	ğŸ’µ	1
The flag Qatar letters Â  QA Â  platforms The Flag Qatar emoji sequence Regional Indicator  	ğŸ‡¶ğŸ‡¦	1
A mountain shown peaks blue sky Similar snow capped mountain emoji Mountain approved Unicode 5.2 200	â›°	1
This version Person Getting Massage emoji Medium dark Skin Tone applied displayed Dark Brown Skin Tone o	ğŸ’†ğŸ¾	1
A sign indicate roadwork construction Generally shown yellow black diagonal stripes physically block	ğŸš§	1
Baggage Claim approved Unicode 6.0 2010 added Emoji 1.0 2015 Copy paste emoji Copy	ğŸ›„	1
A red fruit contains stone Known wild cherry Â  UK Cherries approved Unicode 6.0 2010 added Emoji	ğŸ’	1
This version Backhand Index Pointing Up emoji Medium light Skin Tone applied displayed Cream White Skin  	ğŸ‘†ğŸ¼	1
The face girl smiling Â  Differentiated Â  woman Â  emoji Â  hairstyle Â  features Â  pigtails Â  present woman	ğŸ‘§	1
This version Man With Chinese Cap emoji Dark Skin Tone applied displayed Black Skin Tone supported pl	ğŸ‘²ğŸ¿	1
The flag Chile letters Â  CL Â  platforms The Flag Chile emoji sequence Regional Indicator  	ğŸ‡¨ğŸ‡±	1
This version Backhand Index Pointing Right emoji Medium light Skin Tone applied displayed Cream White Sk	ğŸ‘‰ğŸ¼	1
A sun appearing cloud Used weather forecasts indicate partially sunny day Sun Behind Cloud approved U	â›…	1
A hat worn traditional British weddings formal occasions This popular playing piece game Monopoly To	ğŸ©	1
A paper ticket theatre sporting event ticketed performance In Apple artwork John Appleseed  	ğŸ«	1
The flag Djibouti letters Â  DJ Â  platforms The Flag Djibouti emoji sequence Regional Indi	ğŸ‡©ğŸ‡¯	1
The flag Bulgaria letters Â  BG Â  platforms The Flag Bulgaria emoji sequence Regional Indi	ğŸ‡§ğŸ‡¬	1
The flag Â  Isle Man Â  letters Â  IM Â  platforms The Flag Isle Man emoji sequence Regiona	ğŸ‡®ğŸ‡²	1
A cookie description appears chocolate chip cookie Â  major platforms On Samsung devices emoji displays t	ğŸª	1
An urn storage ashes cremation Funeral Urn approved Unicode 4.1 2005 added Emoji 1.0 2015	âš±	1
A station presumed Â  train station Displays train alongside platform passengers board Station approved o	ğŸš‰	1
A koala emoji native Australian marsupial lives trees Known sleeping eating leaves eucalyptus tree Koala	ğŸ¨	1
The flag Algeria letters DZ platforms The Flag Algeria emoji sequence Regional Indica	ğŸ‡©ğŸ‡¿	1
This version Person Gesturing NO emoji Medium Skin Tone applied displayed Moderate Brown Skin Tone su	ğŸ™…ğŸ½	1
An icon outlined sun increasing Â  brightness screen Appears larger Â  Low Brightness Symbol Bright Button	ğŸ”†	1
A fish lives tropical warm water generally colorful appearance Shown Â  fish blue yellow half Appl	ğŸ 	1
The flag San Marino letters Â  SM Â  platforms The Flag San Marino emoji sequence Regional  	ğŸ‡¸ğŸ‡²	1
Two masks maps indicate theatre originate Greek Theatre masks tragedy comedy One mask Â  frowns ot	ğŸ­	1
A man wearing gua pi mao type Chinese hat Sometimes referred skullcap Man With Chinese Cap approved Unicode	ğŸ‘²	1
An alcoholic beverage popular Japan called rice wine rice Shown Â  sake bottle small bowl like cu	ğŸ¶	1
The flag Â  Uzbekistan letters Â  UZ Â  platforms The Flag Uzbekistan emoji sequence Regional  	ğŸ‡ºğŸ‡¿	1
A Â  snail shown distinctive spiral shell Differs greatly color style different platforms Snail approved Un	ğŸŒ	1
Fountain Pen approved Unicode 7.0 2014 â€œ Lower Left Fountain Pen â€ added Emoji 1.0 2015 Copy p	ğŸ–‹	1
A motorized speedboat recreation lakes Â  bodies water Speedboat approved Unicode 6.0 2010 adde	ğŸš¤	1
The flag Â  Netherlands letters Â  NL Â  platforms The Flag Netherlands emoji sequence Regiona	ğŸ‡³ğŸ‡±	1
A leopard emoji yellow gold colored coat Â  black spots Leopard approved Unicode 6.0 2010 added E	ğŸ†	1
This version Thumbs Down emoji Light Skin Tone applied displayed Pale Skin Tone supported platforms  	ğŸ‘ğŸ»	1
This version Backhand Index Pointing Up emoji Light Skin Tone applied displayed Pale Skin Tone suppor	ğŸ‘†ğŸ»	1
The flag Â  Malawi letters Â  MW Â  platforms The Flag Malawi emoji sequence Regional Indicato	ğŸ‡²ğŸ‡¼	1
A traditional radio speaker grille tuner controls antenna Radio approved Unicode 6.0 2010 added Emoji 1	ğŸ“»	1
The crescent moon star Â  symbol associated religion Â  Islam This symbol found Â  flags countries	â˜ª	1
A chart showing figures increasing time upward tick A type line graph Chart Increasing approved Unicode 6	ğŸ“ˆ	1
A Â  form public transport rails usually found streets cities urban areas For short medium length journeys Trams	ğŸšŠ	1
Flatbread containing items salad sliced meat falafel A fast food item popular parts middle east May come	ğŸ¥™	1
This version Person Bowing emoji Medium Skin Tone applied displayed Moderate Brown Skin Tone supporte	ğŸ™‡ğŸ½	1
A black spider legs similar appearance funnel web spider Spider approved Unicode 7.0 2014 added	ğŸ•·	1
This version Bride With Veil emoji Medium Skin Tone applied displayed Moderate Brown Skin Tone suppor	ğŸ‘°ğŸ½	1
A person surfboard riding Â  wave ocean Wears wetsuit Â  board shorts versions Person Surfing approved par	ğŸ„	1
An envelope shown arriving incoming Incoming Envelope approved Unicode 6.0 2010 added Emoji 1.0 2015	ğŸ“¨	1
A symbol showing capital Â  letters Â  A B C Â  D. Intended software keyboard input screen Â  toggle capital lett	ğŸ” 	1
A magnifying glass pointing right The Â  Right Pointing Magnifying Glass Emoji Â  glass left Â  instead  	ğŸ”	1
This version Person Tipping Hand emoji Light Skin Tone applied displayed Pale Skin Tone supported pla	ğŸ’ğŸ»	1
The flag Fiji letters Â  FJ Â  platforms The Flag Fiji emoji sequence Regional Indicator Sy	ğŸ‡«ğŸ‡¯	1
This version Person Biking emoji Medium dark Skin Tone applied displayed Dark Brown Skin Tone support	ğŸš´ğŸ¾	1
The flag Sint Maarten letters Â  SX Â  platforms This Dutch half Caribbean island Sain	ğŸ‡¸ğŸ‡½	1
The face young infant baby Shows Â   face baby Â  Â  small hair Â  platforms Android shows swaddled b	ğŸ‘¶	1
This version OK Hand emoji Light Skin Tone applied displayed Pale Skin Tone supported platforms Copy	ğŸ‘ŒğŸ»	1
A male sheep known ram spiralled horns Ram approved Unicode 6.0 2010 added Emoji 1.0 2015 Copy	ğŸ	1
Face scrunched closed eyes frowning Used helplessness situation May verge tears Persevering Face w	ğŸ˜£	1
Most commonly lightning bolt stormy weather symbol intended Â  warning high voltage Apple uses sym	âš¡	1
This version Person Gesturing OK emoji Medium Skin Tone applied displayed Moderate Brown Skin Tone su	ğŸ™†ğŸ½	1
Small Blue Diamond approved Unicode 6.0 2010 added Emoji 1.0 2015 Copy paste emoji Copy	ğŸ”¹	1
Two women displayed kissing gesturing kiss At small sizes difficult discern Â  men kissing Th	ğŸ‘©â€â¤ï¸â€ğŸ’‹â€ğŸ‘©	1
A shoe worn man work dinner occasion requires footwear Unlike womens shoes shoe likely comfortabl	ğŸ‘	1
A family Â  fathers Â  son The Family Man Man Boy emoji sequence Man Man Boy emojis These com	ğŸ‘¨â€ğŸ‘¨â€ğŸ‘¦	1
Hammer Pick approved Unicode 4.1 2005 added Emoji 1.0 2015 Copy paste emoji Copy	âš’	1
The flag Â  Kuwait letters Â  KW Â  platforms The Flag Kuwait emoji sequence Regional Indicato	ğŸ‡°ğŸ‡¼	1
This version Old Woman emoji Medium Skin Tone applied displayed Moderate Brown Skin Tone supported pl	ğŸ‘µğŸ½	1
The flag Â  Micronesia letters Â  FM Â  platforms The Flag Micronesia emoji sequence Regional  	ğŸ‡«ğŸ‡²	1
A high heeled shoe worn women office jobs social occasions Shown different colors Â  artwork Apple red Google pink	ğŸ‘ 	1
A speaker cone displayed sound Â  waves Speaker Low Volume approved Unicode 6.0 2010 â€œ Speaker â€	ğŸ”ˆ	1
This version Woman emoji Medium dark Skin Tone applied displayed Dark Brown Skin Tone supported platf	ğŸ‘©ğŸ¾	1
Exclamation Mark approved Unicode 5.2 2009 â€œ Heavy Exclamation Mark Symbol â€ added Emoji 1.0 2015  	â—	1
The flag Â  Tajikistan letters Â  TJ Â  platforms The Flag Tajikistan emoji sequence Regional  	ğŸ‡¹ğŸ‡¯	1
A person Â  hand air characters Â  wants ask answer question Displayed female girl woman Apple	ğŸ™‹	1
This version Person Rowing Boat emoji Medium dark Skin Tone applied displayed Dark Brown Skin Tone su	ğŸš£ğŸ¾	1
A lit bridge Â  shown night Bridge Night approved Unicode 6.0 2010 added Emoji 1.0 2015 Copy paste  	ğŸŒ‰	1
A green heart emoji The Android 4.4 artwork emoji appeared beads sweat orange pink heart Green Heart app	ğŸ’š	1
A bird enjoys spending time water Shown platforms Â  mallard Â  brown white green colors Samsung displays thi	ğŸ¦†	1
A rhinoceros displayed entire animal face Rhinoceros approved Unicode 9.0 2016 added E	ğŸ¦	1
A satellite orbits earth generally communications weather GPS Satellite approved Unicode 7	ğŸ›°	1
The flag French Polynesia letters Â  PF Â  platforms The Flag French Polynesia emoji sequence  	ğŸ‡µğŸ‡«	1
Index finger pointing right Backhand Index Pointing Right approved Unicode 6.0 2010 â€œ White Right Po	ğŸ‘‰	1
Mount Fuji called Â  Fuji san Japan largest mountain Japan Often seen snow peak colder months year It	ğŸ—»	1
A bicycle red stroke indicating Â  bikes prohibited location May seen pedestrian malls bicy	ğŸš³	1
A crystal ball Â  Â  clairvoyant Â  Â  information inform person future Crystal Ball approved Unicode 6	ğŸ”®	1
An angelic baby wings halo head Commonly known cherub Baby Angel approved Unicode 6.0 2010	ğŸ‘¼	1
Large Blue Diamond approved Unicode 6.0 2010 added Emoji 1.0 2015 Copy paste emoji Copy	ğŸ”·	1
The flag Gambia letters Â  GM Â  platforms The Flag Gambia emoji sequence Regional Indicato	ğŸ‡¬ğŸ‡²	1
A triangle shaped arrow pointing Styled similarly left right pointing triangles iOS shown red Windows ora	ğŸ”¼	1
A face mouth wide open generally Â  represent Â  element surprise Can Â  â€œ mock shock â€ le	ğŸ˜®	1
The flag Â  Nigeria letters Â  NG Â  platforms The Flag Nigeria emoji sequence Regional Indica	ğŸ‡³ğŸ‡¬	1
The Â  Taurus astrological sign Zodiac This Zodiac Symbol represents Bull Taurus approved Unicode 1.1 1993 add	â™‰	1
A white baseball regulation red stitching Used game baseball Baseball approved Unicode 5.2	âš¾	1
A friendly goofy smile tongue hanging mouth Used indicate silly happiness Face Savouring Delicious Food	ğŸ˜‹	1
An hourglass generally shown flowing sand This hourglass emoji Snapchat indicate Snapstreak soon end Hourgl	âŒ›	1
This face Â  sweat dripping brow stressful situation Not confused Crying Face emoji tear	ğŸ˜¥	1
A blouse worn women neat casual setting Shown pink Apple devices yellow Android purple Twitter Similar	ğŸ‘š	1
This version Oncoming Fist emoji Dark Skin Tone applied displayed Black Skin Tone supported platforms	ğŸ‘ŠğŸ¿	1
A family father mother sons The Family Man Woman Boy Boy emoji sequence Man Woman Boy Bo	ğŸ‘¨â€ğŸ‘©â€ğŸ‘¦â€ğŸ‘¦	1
A large capacity stadium featuring large seating Â  sporting fans people attending shows hosted stadium Stad	ğŸŸ	1
A motor scooter displayed type motorbike step frame Distinct racing motorcycle  	ğŸ›µ	1
A decorative heart displays Apple devices white heart shaped cutout pink purple roundrect Heart Decoration approve	ğŸ’Ÿ	1
The flag Â  Macedonia letters Â  MK Â  platforms The Flag Macedonia emoji sequence Regional In	ğŸ‡²ğŸ‡°	1
Control Knobs approved Unicode 7.0 2014 added Emoji 1.0 2015 Copy paste emoji Copy	ğŸ›	1
This version Bride With Veil emoji Light Skin Tone applied displayed Pale Skin Tone supported platfor	ğŸ‘°ğŸ»	1
A face air coming nose proud disdainful way Commonly representing frustration situation	ğŸ˜¤	1
This version Person Gesturing OK emoji Medium dark Skin Tone applied displayed Dark Brown Skin Tone s	ğŸ™†ğŸ¾	1
The flag Australia letters AU platforms The Flag Australia emoji sequence Regional In	ğŸ‡¦ğŸ‡º	1
The Â  word Â  exclamation point shown enclosed Â  square Originally intended denote Â  leveling game UP Button  	ğŸ†™	1
A person surgical mask face generally Â  hospital Â  setting working dangerous fumes Also Â  seen Â  public	ğŸ˜·	1
A campsite featuring tent tree campfire Similar tent emoji Camping approved Unicode 7.0 20	ğŸ•	1
Heavy Minus Sign approved Unicode 6.0 2010 added Emoji 1.0 2015 Copy paste emoji Copy	â–	1
This version Open Hands emoji Medium Skin Tone applied displayed Moderate Brown Skin Tone supported p	ğŸ‘ğŸ½	1
This version Folded Hands emoji Medium dark Skin Tone applied displayed Dark Brown Skin Tone supporte	ğŸ™ğŸ¾	1
A telescope Â  view closer detail stars objects night sky Telescope approved Unicode 6.0 2010	ğŸ”­	1
White Medium small Square approved Unicode 3.2 2002 â€œ White Medium Small Square â€ added Emoji 1.0 2	â—½	1
This version Construction Worker emoji Medium Skin Tone applied displayed Moderate Brown Skin Tone su	ğŸ‘·ğŸ½	1
A green Â  apple fruit variety Green Apple approved Unicode 6.0 2010 added Emoji 1.0 2015 Copy paste  	ğŸ	1
A red ripe tomato emoji Looks similar red apple emoji small sizes Tomato approved Unicode 6.0 2010 added  	ğŸ…	1
A Â  motorcycle known motorbike sport racing purposes For transport based motorcycle use motor scooter Motorcyc	ğŸ	1
A yellow gold colored love heart Â  Inexplicably displayed pink hairy heart Â  Android 4.4 On Â  Snapchat Â  Â  emoji co	ğŸ’›	1
A wrapped piece sugar candy treat children May given Halloween kids trick treating Known sweets lo	ğŸ¬	1
Six Oâ€™clock approved Unicode 6.0 2010 â€œ Clock Face Six O'Clock â€ added Emoji 1.0 2015 Copy pas	ğŸ••	1
The red dragon tile game Japanese Mahjong White Â  red Â  character printed Mahjong Red Dragon approved U	ğŸ€„	1
Face eyes closed sleep symbol â€“ Zzz â€“ head Generally instead Â  Sleepy Face Emoji Â  indicate sleeping	ğŸ˜´	1
An umbrella closed likely result collapsing prior going indoors Shows pink Apple devices blue Â  Android	ğŸŒ‚	1
A graph showing current value Japanese Yen Chart Increasing With Yen approved Unicode 6.0 2010  	ğŸ’¹	1
A sterotypically â€œ nerd like â€ face glasses buck teeth Nerd Face approved Unicode 8.0 2015 added Emoji 1.0	ğŸ¤“	1
White Large Square approved Unicode 5.1 2008 added Emoji 1.0 2015 Copy paste emoji Copy	â¬œ	1
A single red rose emoji Sometimes Â  Â  display romance Â  pleasant smell Rose approved Unicode 6.0 20	ğŸŒ¹	1
A tennis racket racquet tennis ball Only ball shown Apple LG Twitter Facebook Mozilla platforms Tennis approv	ğŸ¾	1
This version Person Biking emoji Medium Skin Tone applied displayed Moderate Brown Skin Tone supporte	ğŸš´ğŸ½	1
A Â  vehicle recreation generally understood mean campervan motorhome May originally intended represen	ğŸš™	1
A face displaying eyes glancing upward indicating eye roll This disdain contempt boredom person topic C	ğŸ™„	1
A speaker cone displayed sound waves generally icon indicate increasing volume phone computer Spea	ğŸ”Š	1
A versatile type knife Â  commonly found Â  kitchens Japan Generally cutting Â  filleting meat fish Not confused wi	ğŸ”ª	1
An orange book reads â€œ Vol 4 John Appleseed â€ Â  cover Apple artwork Orange Book approved Unicode 6.0 2	ğŸ“™	1
A beer lager glass Â  stein Shown froth head spilling Beer Mug approved Unicode 6.0 2010	ğŸº	1
This version Flexed Biceps emoji Dark Skin Tone applied displayed Black Skin Tone supported platforms	ğŸ’ªğŸ¿	1
A gift wrapped variety Â  paper colors ribbon bow decoration Commonly birthdays Christmas gift-	ğŸ	1
This version Person Surfing emoji Medium dark Skin Tone applied displayed Dark Brown Skin Tone suppor	ğŸ„ğŸ¾	1
Stands Digital Video Disc Digital Versatile Disc type optical media movie distribution DVD Video storing files  	ğŸ“€	1
This emoji kissing looks like whistling emoji blowing air A bit â€˜ innocent I pretending I anythin	ğŸ˜™	1
A soft serve ice cream cone The ice cream white color implies vanilla flavored platforms Windows displ	ğŸ¦	1
This version Baby emoji Medium Skin Tone applied displayed Moderate Brown Skin Tone supported platfor	ğŸ‘¶ğŸ½	1
The flag Andorra letters AD platforms The Flag Andorra emoji sequence Regional Indica	ğŸ‡¦ğŸ‡©	1
A pumpkin emoji carved Jack oâ€™-lantern halloween Jack o lantern approved Unicode 6.0 2010 â€œ Jac	ğŸƒ	1
A chicken yellow beak red comb head red wattle chin Not mistaken rooster emoji Somet	ğŸ”	1
Means â€œ agreement â€ Japanese More literally means unite join CJK Ideographs characters Chinese Japanese  	ğŸˆ´	1
This version Person Rowing Boat emoji Dark Skin Tone applied displayed Black Skin Tone supported plat	ğŸš£ğŸ¿	1
The face Â  Mother Nature Â  character creating wind blowing air mouth Wind Face approved Unicode 7.0 2014 un	ğŸŒ¬	1
The flag Â  Kiribati letters Â  KI Â  platforms The Flag Kiribati emoji sequence Regional Indi	ğŸ‡°ğŸ‡®	1
A fax machine Â  allows Â  sending scanned page text images Â  standard telephone line Popular Â  1980s 1990s	ğŸ“ 	1
A point shoot Â  camera photos popularity smartphones Shown burst light display flash going o	ğŸ“¸	1
A fork knife shown dinner plate May accompanied Â  spoon emoji Fork Knife With Plate approved pa	ğŸ½	1
Biohazard approved Unicode 1.1 1993 â€œ Biohazard Sign â€ added Emoji 1.0 2015 Copy paste em	â˜£	1
A moon unobstructed shadow cast earth Also said time werewolves Full Moon approve	ğŸŒ•	1
The flag Â  Malaysia letters Â  MY Â  platforms The Flag Malaysia emoji sequence Regional Indi	ğŸ‡²ğŸ‡¾	1
The Flag St. Kitts Nevis emoji sequence Regional Indicator Symbol LetÂ­ter K Regional Indicator Symbol LetÂ­ter N  	ğŸ‡°ğŸ‡³	1
This version Person Getting Haircut emoji Medium Skin Tone applied displayed Moderate Brown Skin Tone	ğŸ’‡ğŸ½	1
This version Person Pouting emoji Medium Skin Tone applied displayed Moderate Brown Skin Tone support	ğŸ™ğŸ½	1
French Fries approved Unicode 6.0 2010 added Emoji 1.0 2015 Copy paste emoji Copy	ğŸŸ	1
A cactus emoji usually found warm desert climates Most commonly displayed branch Â  Saguaro cactus Cactus approved p	ğŸŒµ	1
This version Backhand Index Pointing Down emoji Light Skin Tone applied displayed Pale Skin Tone supp	ğŸ‘‡ğŸ»	1
A pastry crescent shape Popular countries associated France Austria Croissant approved par	ğŸ¥	1
The Â  Sagittarius astrological sign Zodiac This Zodiac Symbol represents Archer Sagittarius approved Unicode 1.1	â™	1
A clock flat base round face Designed sit mantel fireplace The time shown clockface 10.10  	ğŸ•°	1
An eject symbol displayed upward pointing triangle horiztonal bar May physical button icon user inte	â	1
A barrell drum contains oil The exterior cylinder shown blue holes Oil Drum approved par	ğŸ›¢	1
A hand thumb Â  little pinky finger extended making traditional Â  phone like shape Â  May conjunction face sugge	ğŸ¤™	1
A prawn Â  coated breadcrumbs fried Known ebi furai Â  Japan referred tempura outside Japan Often found include	ğŸ¤	1
A telephone receiver Â  telephone microphone speak speaker listen person end	ğŸ“	1
This version Girl emoji Medium dark Skin Tone applied displayed Dark Brown Skin Tone supported platfo	ğŸ‘§ğŸ¾	1
This version Flexed Biceps emoji Light Skin Tone applied displayed Pale Skin Tone supported platforms	ğŸ’ªğŸ»	1
This version Vulcan Salute emoji Dark Skin Tone applied displayed Black Skin Tone supported platforms	ğŸ––ğŸ¿	1
This version Thumbs Up emoji Medium Skin Tone applied displayed Moderate Brown Skin Tone supported pl	ğŸ‘ğŸ½	1
This version Old Man emoji Light Skin Tone applied displayed Pale Skin Tone supported platforms Copy	ğŸ‘´ğŸ»	1
A small black ant Created photorealistic style Apple artwork cartoon style Google version Ant approved	ğŸœ	1
A butterfly shown wings spread Commonly displayed Â  monarch butterfly orange black wings Butterfly approved  	ğŸ¦‹	1
A sweet potato incorrectly referred yam North America Â  Can range skin colors purple red beige	ğŸ 	1
A panda head Panda Face approved Unicode 6.0 2010 added Emoji 1.0 2015 Copy paste emoji Copy	ğŸ¼	1
A postal horn usually called post horn Â  18th 19th centuries indicate mail coach arriving deliver	ğŸ“¯	1
This version Folded Hands emoji Medium Skin Tone applied displayed Moderate Brown Skin Tone supported	ğŸ™ğŸ½	1
The flag Canary Islands letters IC platforms The Flag Canary Islands emoji sequence R	ğŸ‡®ğŸ‡¨	1
This version Person Biking emoji Light Skin Tone applied displayed Pale Skin Tone supported platforms	ğŸš´ğŸ»	1
This version Oncoming Fist emoji Light Skin Tone applied displayed Pale Skin Tone supported platforms	ğŸ‘ŠğŸ»	1
A collection colorful flowers arranged bouquet given gift wedding mother day Â  valentine day Â  occa	ğŸ’	1
A hotel building Â  displayed platforms building windows letter H Can easily confused L	ğŸ¨	1
A sharp Â  pointed Â  knife stabbing generally weapon Looks similar sword smaller held easily	ğŸ—¡	1
A bowl containing scoops ice cream Ice Cream approved Unicode 6.0 2010 added Emoji 1.0 2015 Cop	ğŸ¨	1
Hearts revolving hearts Apple artwork emoji shows Â  hearts switching places circular line sim	ğŸ’	1
The flag Â  United Arab Emirates letters Â  AE Â  platforms The Flag United Arab Emirates emoji sequence	ğŸ‡¦ğŸ‡ª	1
This version Person Rowing Boat emoji Medium Skin Tone applied displayed Moderate Brown Skin Tone sup	ğŸš£ğŸ½	1
This version Baby Angel emoji Medium Skin Tone applied displayed Moderate Brown Skin Tone supported p	ğŸ‘¼ğŸ½	1
The flag Spain letters Â  ES Â  platforms The Flag Spain emoji sequence Regional Indicator  	ğŸ‡ªğŸ‡¸	1
A red octagonal sign Used countries stop sign Stop Sign approved Unicode 9.0 2016 â€œ Octagona	ğŸ›‘	1
This version Ear emoji Medium Skin Tone applied displayed Moderate Brown Skin Tone supported platform	ğŸ‘‚ğŸ½	1
A tent protection wind rain camping Often shown night time stars Tent approved Unicode 5	â›º	1
File Cabinet approved Unicode 7.0 2014 added Emoji 1.0 2015 Copy paste emoji Copy	ğŸ—„	1
This version Nail Polish emoji Light Skin Tone applied displayed Pale Skin Tone supported platforms  	ğŸ’…ğŸ»	1
A large blue Â  whale emoji Appears Â  humpback whale Apple artwork Distinct spouting whale emoji Whale approved  	ğŸ‹	1
A small version large orange diamond emoji Small Orange Diamond approved Unicode 6.0 2010 added Emoji 1.0	ğŸ”¸	1
The flag Â  Mauritius letters Â  MU Â  platforms The Flag Mauritius emoji sequence Regional In	ğŸ‡²ğŸ‡º	1
A streaking comet appearing ball light light streak Similar shooting star emoji Comet approved pa	â˜„	1
A pile poo shaped like soft serve ice cream Â  Brown color friendly smile versions emoji Previously sh	ğŸ’©	1
This version Person Surfing emoji Light Skin Tone applied displayed Pale Skin Tone supported platform	ğŸ„ğŸ»	1
This version Santa Claus emoji Dark Skin Tone applied displayed Black Skin Tone supported platforms  	ğŸ…ğŸ¿	1
White Square Button White Square Button approved Unicode 6.0 2010 added Emoji 1.0 2015 Copy paste emo	ğŸ”³	1
The face cat looking directly forward Shown yellow gray platforms emoji generally cartoon style appearance  	ğŸ±	1
This version Woman emoji Medium Skin Tone applied displayed Moderate Brown Skin Tone supported platfo	ğŸ‘©ğŸ½	1
A train specified type Â  Due presence steam train fast train emoji likely regular electrified dies	ğŸš†	1
A dove carrying olive branch symbol peace Dove approved Unicode 7.0 2014 â€œ Dove Peace â€  	ğŸ•Š	1
A domestic house cat shown facing left screen major platforms Distinct cat face emoji cat emoji shows bo	ğŸˆ	1
Seven Oâ€™clock approved Unicode 6.0 2010 â€œ Clock Face Seven O'Clock â€ added Emoji 1.0 2015 Copy	ğŸ•–	1
The international symbol access denote Â  facility designed wheelchair users mind Appears blue sign	â™¿	1
The flag Â  Tokelau letters Â  TK Â  platforms The Flag Tokelau emoji sequence Regional Indica	ğŸ‡¹ğŸ‡°	1
A closed mailbox flag raised The flag Â  mailbox USA indicate Â  mail delivered  	ğŸ“«	1
A flag black white squares shown checkerboard pattern signal start end motor car race Chequered Flag	ğŸ	1
The flag Bermuda letters Â  BM Â  platforms The Flag Bermuda emoji sequence Regional Indica	ğŸ‡§ğŸ‡²	1
A cow black white patched coat likely Â  Holstein Â  Freisan breed Cow approved Unicode 6.0 2010 added Emo	ğŸ„	1
This version Thumbs Down emoji Medium Skin Tone applied displayed Moderate Brown Skin Tone supported  	ğŸ‘ğŸ½	1
This version Person Getting Massage emoji Medium Skin Tone applied displayed Moderate Brown Skin Tone	ğŸ’†ğŸ½	1
Carp shaped wind socks Â  traditionally flown Japan celebrate Children Day Carp Streamer approved Unicode 6.0 2010	ğŸ	1
A cucumber emoji pickle gherkin Cucumber approved Unicode 9.0 2016 added Em	ğŸ¥’	1
A Â  tornado appearing come cloud sky Tornado approved Unicode 7.0 2014 â€œ Cloud With T	ğŸŒª	1
A symbol showing following Â  glyphs Â  Japanese postal mark music note ampersand symbol Â  percent	ğŸ”£	1
The flag Bangladesh letters Â  BD Â  platforms The Flag Bangladesh emoji sequence Regional  	ğŸ‡§ğŸ‡©	1
A hat worn women sun protection fashion The Apple version hat straw green bow Â  Goo	ğŸ‘’	1
Heavy Dollar Sign approved Unicode 6.0 2010 added Emoji 1.0 2015 Copy paste emoji Copy	ğŸ’²	1
Denim jeans worn men Â  women A popular form casual Â  trousers worn runner emoji Apple emoji artwork Jeans approved	ğŸ‘–	1
This version Person Mountain Biking emoji Medium light Skin Tone applied displayed Cream White Skin Tone	ğŸšµğŸ¼	1
The flag Singapore letters Â  SG Â  platforms The Flag Singapore emoji sequence Regional In	ğŸ‡¸ğŸ‡¬	1
A family mothers Â  daughter The Family Woman Woman Girl emoji sequence Woman Woman Girl emojis	ğŸ‘©â€ğŸ‘©â€ğŸ‘§	1
This version OK Hand emoji Dark Skin Tone applied displayed Black Skin Tone supported platforms Copy	ğŸ‘ŒğŸ¿	1
The flag Â  Swaziland letters Â  SZ Â  platforms The Flag Swaziland emoji sequence Regional In	ğŸ‡¸ğŸ‡¿	1
A rooster male chicken known cockerel cock Rooster approved Unicode 6.0 2010 added Emoji 1.0 20	ğŸ“	1
A storm cloud Â  bolt lightning coming Cloud With Lightning approved Unicode 7.0 2014 added Emoji	ğŸŒ©	1
The flag Hungary letters Â  HU Â  platforms The Flag Hungary emoji sequence Regional Indica	ğŸ‡­ğŸ‡º	1
This version Person Gesturing NO emoji Medium dark Skin Tone applied displayed Dark Brown Skin Tone s	ğŸ™…ğŸ¾	1
This face amused This face sadness grumpy displeased look Used express dissatisfaction The eyes	ğŸ˜’	1
This version Guard emoji Dark Skin Tone applied displayed Black Skin Tone supported platforms Copy	ğŸ’‚ğŸ¿	1
Red Circle approved Unicode 6.0 2010 â€œ Large Red Circle â€ added Emoji 1.0 2015 Copy paste	ğŸ”´	1
A flower died wilted lack water A petal falls ground Wilted Flower approved Unicode 9.0	ğŸ¥€	1
A sunflower emoji Bright yellow Give smile Sunflower approved Unicode 6.0 2010 added	ğŸŒ»	1
A fist displayed Â  position punch fist bump person Shown right hand supported platforms An equiva	ğŸ‘Š	1
This version Raised Hand emoji Medium dark Skin Tone applied displayed Dark Brown Skin Tone supported  	âœ‹ğŸ¾	1
A microscope found science labs magnifying insects rocks small Â  objects Microscope approved Unicode 6.0	ğŸ”¬	1
This version Guard emoji Medium light Skin Tone applied displayed Cream White Skin Tone supported pla	ğŸ’‚ğŸ¼	1
The flag Dominica letters Â  DM Â  platforms Dominican Flag Emoji The Flag Dominica emoji sequen	ğŸ‡©ğŸ‡²	1
Arrows pointing clockwise direction number 1 badge lower corner Â Â  Used music player applications Â  loop track	ğŸ”‚	1
Desert approved Unicode 7.0 2014 added Emoji 1.0 2015 Copy paste emoji Copy	ğŸœ	1
A symbol representing email As universal email logo symbol differs platforms Shown lett	ğŸ“§	1
This version Old Man emoji Medium dark Skin Tone applied displayed Dark Brown Skin Tone supported pla	ğŸ‘´ğŸ¾	1
The flag Â  Kenya letters Â  KE Â  platforms The Flag Kenya emoji sequence Regional Indicator  	ğŸ‡°ğŸ‡ª	1
An awareness ribbon worn Â  support cause group Reminder Ribbon approved Unicode 7.0 2014 added Emoj	ğŸ—	1
The flag Gabon letters Â  GA Â  platforms The Flag Gabon emoji sequence Regional Indicator  	ğŸ‡¬ğŸ‡¦	1
The flag Â  Nepal letters Â  NP Â  platforms The Flag Nepal emoji sequence Regional Indicator  	ğŸ‡³ğŸ‡µ	1
Railway Track approved Unicode 7.0 2014 added Emoji 1.0 2015 Copy paste emoji Copy	ğŸ›¤	1
An industrial factory flue gas stacks releasing exhaust air Factory approved Unicode 6.0 2010 added	ğŸ­	1
This version Man emoji Medium Skin Tone applied displayed Moderate Brown Skin Tone supported platform	ğŸ‘¨ğŸ½	1
A middle finger emoji western cultures rude insulting Â  gesture The hand shown middle finger ra	ğŸ–•	1
The flag Puerto Rico letters Â  PR Â  platforms The Flag Puerto Rico emoji sequence Regiona	ğŸ‡µğŸ‡·	1
This version Raised Fist emoji Dark Skin Tone applied displayed Black Skin Tone supported platforms C	âœŠğŸ¿	1
The silhouette person speaking Faces right lines demonstrating speech shown coming mouth Speaking Head appr	ğŸ—£	1
This version Nose emoji Medium Skin Tone applied displayed Moderate Brown Skin Tone supported platfor	ğŸ‘ƒğŸ½	1
The flag Solomon Islands letters Â  SB Â  platforms The Flag Solomon Islands emoji sequence	ğŸ‡¸ğŸ‡§	1
A family Â  Â  mothers Â  sons The Family Woman Woman Boy Boy emoji sequence Woman Woman Boy Boy	ğŸ‘©â€ğŸ‘©â€ğŸ‘¦â€ğŸ‘¦	1
An orange colored fruit tastes similar mandarin Known citrus unshiu Japan fruit exported wo	ğŸŠ	1
A symbol relation religion Â  Â  Judaism Not confused Â  Six Pointed Star With Middle Dot emoji Star Davi	âœ¡	1
This version Girl emoji Dark Skin Tone applied displayed Black Skin Tone supported platforms Copy	ğŸ‘§ğŸ¿	1
A face displayed sneezing tissue blowing closed eyes Sneezing Face approved Unicode 9.0 2016  	ğŸ¤§	1
The Flag Turks Caicos Islands emoji sequence Regional Indicator Symbol LetÂ­ter T Regional Indicator Symbol LetÂ­t	ğŸ‡¹ğŸ‡¨	1
The flag Canada letters Â  CA Â  platforms The Flag Canada emoji sequence Regional Indicato	ğŸ‡¨ğŸ‡¦	1
The flag Benin letters Â  BJ Â  platforms The Flag Benin emoji sequence Regional Indicator  	ğŸ‡§ğŸ‡¯	1
Gear approved Unicode 4.1 2005 added Emoji 1.0 2015 Copy paste emoji Copy	âš™	1
An elderly female face Â  Â  gray Â  hair visible wrinkles Old Woman approved Unicode 6.0 2010 â€œ Older Wom	ğŸ‘µ	1
The flag Central African Republic letters Â  CF Â  platforms The Flag Central African Republic emoji  	ğŸ‡¨ğŸ‡«	1
This version Woman emoji Medium light Skin Tone applied displayed Cream White Skin Tone supported pla	ğŸ‘©ğŸ¼	1
A red lantern hung outside Â  izakaya Japan type bar Â  small meals available Suitable casual evening eat and/	ğŸ®	1
A herb basil oregano Appears platforms small green plant 3 6 leaves Herb approved Unicode 6	ğŸŒ¿	1
A locked closed padlock Â  real world Â  secure object symbol security SSL certificate web Fun  	ğŸ”’	1
A violin emoji Sometimes Â Â  Â  context Â  world smallest violin Violin approved Unicode 6.0 2010 added  	ğŸ»	1
The flag Mauritania letters Â  MR Â  platforms The Flag Mauritania emoji sequence Regional  	ğŸ‡²ğŸ‡·	1
This version Person Taking Bath emoji Medium Skin Tone applied displayed Moderate Brown Skin Tone sup	ğŸ›€ğŸ½	1
A large department store selling range products general public Shown large building billboard platforms o	ğŸ¬	1
A non motorized scooter wheels handles Kick Scooter approved Unicode 9.0 2016 â€œ Scooter â€  	ğŸ›´	1
A car shown The windscreen hood bonnet British English car seen facing forward This car	ğŸš˜	1
A staff stave showing treble clef horizontal lines Musical Score approved Unicode 6.0 2010 added E	ğŸ¼	1
This version Girl emoji Medium Skin Tone applied displayed Moderate Brown Skin Tone supported platfor	ğŸ‘§ğŸ½	1
A smiling moon said slightly creepy face Not confused moon face Full Moon With F	ğŸŒ	1
This version Backhand Index Pointing Right emoji Dark Skin Tone applied displayed Black Skin Tone sup	ğŸ‘‰ğŸ¿	1
The flag China letters Â  CN Â  platforms The Flag China emoji sequence Regional Indicator  	ğŸ‡¨ğŸ‡³	1
A small clock Â  bells scare person awake pre set time Alarm Clock approved Unicode 6.0 2010 added	â°	1
An inbox tray Â  icon email outbox Â  A paper tray arrow pointing Â  tray Outbox Tray approved	ğŸ“¤	1
This version Backhand Index Pointing Down emoji Medium light Skin Tone applied displayed Cream White Ski	ğŸ‘‡ğŸ¼	1
A place people taken receive medical care This hospital large red cross symbol health  	ğŸ¥	1
The flag Barbados letters Â  BB Â  platforms The Flag Barbados emoji sequence Regional Indi	ğŸ‡§ğŸ‡§	1
VS Button approved Unicode 6.0 2010 â€œ Squared Vs â€ added Emoji 1.0 2015 Copy paste emoji	ğŸ†š	1
A face wide open eyes raised eyebrows Appears shocked scary event Fearful Face approved Unicode 6.0  	ğŸ˜¨	1
This version Nail Polish emoji Medium dark Skin Tone applied displayed Dark Brown Skin Tone supported	ğŸ’…ğŸ¾	1
A bound yellow ledger book Ledger approved Unicode 6.0 2010 added Emoji 1.0 2015 Copy paste emoji C	ğŸ“’	1
Building Construction approved Unicode 7.0 2014 added Emoji 1.0 2015 Copy paste emoji Copy	ğŸ—	1
A radio button user interface element form fields choices Differs checkbox response  	ğŸ”˜	1
An open folder store Â  files filing cabinet May Â  icon opened folder browsing computer files Open File  	ğŸ“‚	1
A car shown Appears red car platforms goes faster Android displays Â  blue car  	ğŸš—	1
The flag Belgium letters Â  BE Â  platforms The Flag Belgium emoji sequence Regional Indica	ğŸ‡§ğŸ‡ª	1
The flag Denmark letters Â  DK Â  platforms The Flag Denmark emoji sequence Regional Indica	ğŸ‡©ğŸ‡°	1
This version Person Biking emoji Medium light Skin Tone applied displayed Cream White Skin Tone suppo	ğŸš´ğŸ¼	1
A bottle champagne sparkling wine Â  celebrations New Year Eve Bottle With Popping Cork approved Unico	ğŸ¾	1
A tongue sticking May Â  childish Â  sign defiance Tongue approved Unicode 6.0 2010 added Emoji 1	ğŸ‘…	1
Black Square Button approved Unicode 6.0 2010 added Emoji 1.0 2015 Copy paste emoji Copy	ğŸ”²	1
An inbox tray Â  icon email inbox A paper tray arrow pointing tray Inbox Tray approved	ğŸ“¥	1
A flat bottomed glass associated drinks whisky rum Shown ice cubes liquid inside glass Tumbler Glass w	ğŸ¥ƒ	1
A family Â  fathers Â  daughters The Family Man Man Girl Girl emoji sequence Man Man Girl Gir	ğŸ‘¨â€ğŸ‘¨â€ğŸ‘§â€ğŸ‘§	1
This version Santa Claus emoji Medium light Skin Tone applied displayed Cream White Skin Tone support	ğŸ…ğŸ¼	1
The flag Brunei Darussalam letters Â  BN Â  platforms The Flag Brunei emoji sequence Region	ğŸ‡§ğŸ‡³	1
Waning Crescent Moon approved Unicode 6.0 2010 â€œ Waning Crescent Moon Symbol â€ added Emoji 1.0 2015	ğŸŒ˜	1
This version Woman emoji Dark Skin Tone applied displayed Black Skin Tone supported platforms Copy	ğŸ‘©ğŸ¿	1
The Flag Trinidad Tobago emoji sequence Regional Indicator Symbol LetÂ­ter T Regional Indicator Symbol LetÂ­ter T  	ğŸ‡¹ğŸ‡¹	1
This version Man With Chinese Cap emoji Medium dark Skin Tone applied displayed Dark Brown Skin Tone  	ğŸ‘²ğŸ¾	1
The flag Iceland letters Â  IS Â  platforms The Flag Iceland emoji sequence Regional Indica	ğŸ‡®ğŸ‡¸	1
A cat grumpy Â  Popularised memes Grumpy Cat Pouting Cat Face approved Unicode 6.0 2010 added  	ğŸ˜¾	1
A type tree found nature Â  lose leaves seasonally stays green year Evergreen Tree approved	ğŸŒ²	1
A wooden coffin store body deceased person Coffin approved Unicode 4.1 2005 added Emoji 1.0 2	âš°	1
A device popular use mobile phones inform person wish speak Today specialty areas	ğŸ“Ÿ	1
The word Â  new shown enclosed Â  square NEW Button approved Unicode 6.0 2010 â€œ Squared New â€ added E	ğŸ†•	1
Five Oâ€™clock approved Unicode 6.0 2010 â€œ Clock Face Five O'Clock â€ added Emoji 1.0 2015 Copy p	ğŸ•”	1
This version Person Raising Hand emoji Medium dark Skin Tone applied displayed Dark Brown Skin Tone s	ğŸ™‹ğŸ¾	1
The flag Â  Yemen letters Â  YE Â  platforms The Flag Yemen emoji sequence Regional Indicator  	ğŸ‡¾ğŸ‡ª	1
The flag Ecuador letters Â  EC Â  platforms The Flag Ecuador emoji sequence Regional Indica	ğŸ‡ªğŸ‡¨	1
Airplane Departure approved Unicode 7.0 2014 added Emoji 1.0 2015 Copy paste emoji Copy	ğŸ›«	1
Ten Oâ€™clock approved Unicode 6.0 2010 â€œ Clock Face Ten O'Clock â€ added Emoji 1.0 2015 Copy pas	ğŸ•™	1
The flag Â  European Union Â  letters Â  EU Â  platforms The Flag European Union emoji sequence R	ğŸ‡ªğŸ‡º	1
The flag Papua New Guinea letters Â  PG Â  platforms The Flag Papua New Guinea emoji sequence  	ğŸ‡µğŸ‡¬	1
The Flag Congo Brazzaville emoji sequence Regional Indicator Symbol LetÂ­ter C Regional Indicator Symbol LetÂ­ter  	ğŸ‡¨ğŸ‡¬	1
An eggplant emoji known aubergine Japan countries speaking British English Â  A long purple looking vegetable Â 	ğŸ†	1
A Â  folder store Â  files filing cabinet Also icon folder GUI operating systems File Folder approved  	ğŸ“	1
This version Baby Angel emoji Medium light Skin Tone applied displayed Cream White Skin Tone supporte	ğŸ‘¼ğŸ¼	1
The Â  cute cartoon style penguin yellow orange colored beak May conjunction socially awkward penguin meme Pengui	ğŸ§	1
Means â€œ work â€ Japanese Â  This Emoji mean â€œ open business â€ precedes business hours CJK Ideographs characters Ch	ğŸˆº	1
A notebook writing Â  notes Has black white dots like static label Notes cover Apple artwork Notebook	ğŸ““	1
The flag Anguilla letters AI platforms The Flag Anguilla emoji sequence Regional Indi	ğŸ‡¦ğŸ‡®	1
This version Boy emoji Dark Skin Tone applied displayed Black Skin Tone supported platforms Copy	ğŸ‘¦ğŸ¿	1
The flag Azerbaijan letters Â  AZ Â  platforms The Flag Azerbaijan emoji sequence Regional  	ğŸ‡¦ğŸ‡¿	1
A bathtub bath tub shower Differs Â  Bath Emoji bath tub pers	ğŸ›	1
A human nose May indicate Â  smelling smells Nose approved Unicode 6.0 2010 added Emoj	ğŸ‘ƒ	1
Paw prints left dog cat possibly wandering paint Paw Prints approved Unicode 6.0 2010 added	ğŸ¾	1
A chipmunk emoji looks similar squirrel Shown brown bushy tail Often shown eating acorn chestnut Chipmunk wa	ğŸ¿	1
A syringe containing appears blood May blood test hospital Syringe approved Unicode 6.0 201	ğŸ’‰	1
This version Person Frowning emoji Dark Skin Tone applied displayed Black Skin Tone supported platfor	ğŸ™ğŸ¿	1
This version Thumbs Up emoji Medium light Skin Tone applied displayed Cream White Skin Tone supported	ğŸ‘ğŸ¼	1
Two men displayed kissing gesturing kiss Â  At small sizes difficult discern women kissing	ğŸ‘¨â€â¤ï¸â€ğŸ’‹â€ğŸ‘¨	1
A beach showing sand umbrella protection sun Beach With Umbrella approved Unicode 7.0 2014 added	ğŸ–	1
This version Construction Worker emoji Medium dark Skin Tone applied displayed Dark Brown Skin Tone s	ğŸ‘·ğŸ¾	1
Two hands placed firmly meaning Â  Â  thank Â  Japanese culture Â  Other common uses character include Â  prayer prayi	ğŸ™	1
Confetti Ball emoji ball containing confetti burst open celebrations New Year Eve Wedding celebratory manner Con	ğŸŠ	1
This version Backhand Index Pointing Left emoji Light Skin Tone applied displayed Pale Skin Tone supp	ğŸ‘ˆğŸ»	1
The joker deck cards usually appearing Â  like court jester Joker approved Unicode 6.0 2010 â€œ Playi	ğŸƒ	1
British money â€“ Â£ 20 note England Wales Scotland Northern Ireland Colloquially referred â€œ quid â€ parts United	ğŸ’·	1
This version Old Man emoji Dark Skin Tone applied displayed Black Skin Tone supported platforms Copy	ğŸ‘´ğŸ¿	1
A place store notes office materials Primarily older men Briefcase approved Unicode 6.0 2010 ad	ğŸ’¼	1
This version Person Running emoji Medium dark Skin Tone applied displayed Dark Brown Skin Tone suppor	ğŸƒğŸ¾	1
The flag Â  Mayotte letters Â  YT Â  platforms The Flag Mayotte emoji sequence Regional Indica	ğŸ‡¾ğŸ‡¹	1
The flag Â  Kazakhstan letters Â  KZ Â  platforms The Flag Kazakhstan emoji sequence Regional  	ğŸ‡°ğŸ‡¿	1
The flag RÃ©union letters Â  RE Â  platforms Shown Volcano Sunbeams Â  flag proposal Vexill	ğŸ‡·ğŸ‡ª	1
A face Â  bank note showing instead tongue Â  dollar signs instead eyes Indicates love money feeling wealth Mo	ğŸ¤‘	1
A yellow taxicab Â  iconically seen New York City Shown opposed oncoming taxi emoji Taxi approved	ğŸš•	1
A black bat enjoys dark shown spreading wings Bat approved Unicode 9.0 2016 added Emoji 3.0 2016	ğŸ¦‡	1
A metro frequent underground train found built areas high populations This emoji generally displayed forward facing tra	ğŸš‡	1
The flag Cook Islands letters Â  CK Â  platforms The Flag Cook Islands emoji sequence Regio	ğŸ‡¨ğŸ‡°	1
A juicy Â  melon Â  A fruit known variety names different parts world Melon approved Unicode 6.0 2010 ad	ğŸˆ	1
A pink heart inside slightly larger pink heart inside larger pink heart Intended impression heart increasing	ğŸ’—	1
This version Construction Worker emoji Light Skin Tone applied displayed Pale Skin Tone supported pla	ğŸ‘·ğŸ»	1
This version Person Pouting emoji Medium light Skin Tone applied displayed Cream White Skin Tone supp	ğŸ™ğŸ¼	1
A face showing stuck tongue winking time Â  Used attempt wacky zany joking Face With Stuck  	ğŸ˜œ	1
An envelope showing arrow pointing Envelope With Arrow approved Unicode 6.0 2010 â€œ Envelope With D	ğŸ“©	1
A green coiled snake sticking forked tongue Snake approved Unicode 6.0 2010 added Emoji 1.0 2015 Copy	ğŸ	1
A bookmark track page read book Not confused label emoji Bookmark approved o	ğŸ”–	1
This version Backhand Index Pointing Down emoji Medium dark Skin Tone applied displayed Dark Brown Skin  	ğŸ‘‡ğŸ¾	1
The flag Â  Malta letters Â  MT Â  platforms The Flag Malta emoji sequence Regional Indicator  	ğŸ‡²ğŸ‡¹	1
An octopus emoji eyes Â  tentacles Between 3 6 tentacles shown versions emoji Shown pin	ğŸ™	1
This version Person Taking Bath emoji Light Skin Tone applied displayed Pale Skin Tone supported plat	ğŸ›€ğŸ»	1
A face narrow closed eyes straight mouth A deliberate display â€˜ comment â€™ opposed completely neutral face Express	ğŸ˜‘	1
A traditional Japanese Castle usually stone wood Japanese Castle approved Unicode 6.0 2010 added Em	ğŸ¯	1
The flag Egypt letters Â  EG Â  platforms The Flag Egypt emoji sequence Regional Indicator  	ğŸ‡ªğŸ‡¬	1
The number 10 Â  square rounded corners designed look like keycap Keycap 10 approved Unicode 6.0 2010  	ğŸ”Ÿ	1
A chestnut emoji Sometimes mistaken acorn A popular snack Japan locations world roasted che	ğŸŒ°	1
This version Raising Hands emoji Medium dark Skin Tone applied displayed Dark Brown Skin Tone support	ğŸ™ŒğŸ¾	1
This version Old Man emoji Medium Skin Tone applied displayed Moderate Brown Skin Tone supported plat	ğŸ‘´ğŸ½	1
A evil version demon Â  Imp Â  Â  cheeky mischievous character originating Germanic Folkore Shows purple iOS orang	ğŸ‘¿	1
A metal C clamp showing screw tightened compress objects pieces wood This tool	ğŸ—œ	1
A red Â  orange yellow maple leaf associated Canada maple leaf Canadian Flag Maple Leaf approved	ğŸ	1
A pretty dress suitable ball party similar occasion Dress approved Unicode 6.0 2010 added Emoji 1	ğŸ‘—	1
The flag Guam letters Â  GU Â  platforms The Flag Guam emoji sequence Regional Indicator Sy	ğŸ‡¬ğŸ‡º	1
The flag Â  Falkland Islands Malvinas Â  letters Â  FK Â  platforms The Flag Falkland Islands emoji seque	ğŸ‡«ğŸ‡°	1
Eight Oâ€™clock approved Unicode 6.0 2010 â€œ Clock Face Eight O'Clock â€ added Emoji 1.0 2015 Copy	ğŸ•—	1
A sad face single tear running eye cheek Hurt upset crying hysterically Some Â  versions emoji	ğŸ˜¢	1
This version Boy emoji Light Skin Tone applied displayed Pale Skin Tone supported platforms Copy	ğŸ‘¦ğŸ»	1
A door enter house May door internal door house Door approved Unicode 6.0 2010	ğŸšª	1
An open hard book blue cover In Apple artwork emoji book open page following text Here  	ğŸ“–	1
The flag South Korea letters Â  KR Â  platforms The Flag South Korea emoji sequence Regiona	ğŸ‡°ğŸ‡·	1
Although named wind chime emoji closely resembles wind bell decoration popular Japan glass Wind Chim	ğŸ	1
Index finger pointing downward Backhand Index Pointing Down approved Unicode 6.0 2010 â€œ White Down Pointing	ğŸ‘‡	1
A set red orange amber green traffic lights intersections Less Â  common Â  vertical Â  traffic light Similar appear	ğŸš¥	1
A leaf leaves Apple artwork fluttering gentle breeze falling ground Leaf Fluttering Wind approved o	ğŸƒ	1
A shark swimming ocean displayed blue gray tone Shark approved Unicode 9.0 2016 added Emoj	ğŸ¦ˆ	1
A symbol represents crash collision Â  An angular burst orange red star like shape Collision approved Un	ğŸ’¥	1
A hand held showing palm May mean stop high Raised Hand approved Unicode 6.0 2010 ad	âœ‹	1
An astonished face wide open mouth gasping shock surprise The Google artwork emoji looks slightly inebriated  	ğŸ˜²	1
A Â  round flower decoration similar shape flower blossom May found ancient sculptures modern military award	ğŸµ	1
The Flag Antigua Barbuda emoji sequence Regional Indicator Symbol LetÂ­ter A Regional Indicator Symbol LetÂ­ter G  	ğŸ‡¦ğŸ‡¬	1
A stick figure icon woman generally indicate female Â  restroom The male Â  equivalent Â  Mens Symbol Â  emoji Women Room	ğŸšº	1
This version Nose emoji Medium light Skin Tone applied displayed Cream White Skin Tone supported plat	ğŸ‘ƒğŸ¼	1
This version Person Surfing emoji Medium Skin Tone applied displayed Moderate Brown Skin Tone support	ğŸ„ğŸ½	1
Grapes Â  commonly found red grapes purple colored white grapes green colored Used Â  create wine Grapes approved p	ğŸ‡	1
A small white mouse shown body opposed mouse face emoji Mouse approved Unicode 6.0 2010 added Emoj	ğŸ	1
A trophy given recognition achievement usually sports The trophy emoji gold cup engraving detailing	ğŸ†	1
A person ball generally displayed basketballer running dribbling bouncing basketball Person Bouncing Ball w	â›¹	1
A key open door lock Shown platforms gold yellow bronze silver DJ Khale	ğŸ”‘	1
Face open eyes open mouth The Apple artwork emoji looks like person yawning Google Microsoft artwork Â  appear clos	ğŸ˜¦	1
This version Woman emoji Light Skin Tone applied displayed Pale Skin Tone supported platforms Copy	ğŸ‘©ğŸ»	1
The Â  Aquarius astrological sign Zodiac This Zodiac Symbol represents Water bearer Aquarius approved Unicode 1.1  	â™’	1
A menorah showing lit candles Jewish holiday Hanukkah Menorah approved Unicode 8.0 2015 na	ğŸ•	1
Motor Boat approved Unicode 7.0 2014 added Emoji 1.0 2015 Copy paste emoji Copy	ğŸ›¥	1
This version Blond haired Person emoji Medium dark Skin Tone applied displayed Dark Brown Skin Tone s	ğŸ‘±ğŸ¾	1
This Emoji meanings One meaning â€œ request â€ Japanese An alternative meaning â€œ monkey â€ Chinese zodiac It commonly  	ğŸˆ¸	1
A piece bikini worn beach pool vacation tropical destination Shown variety colors patterns diff	ğŸ‘™	1
This version Person Surfing emoji Dark Skin Tone applied displayed Black Skin Tone supported platform	ğŸ„ğŸ¿	1
The flag Cuba letters Â  CU Â  platforms The Flag Cuba emoji sequence Regional Indicator Sy	ğŸ‡¨ğŸ‡º	1
The cat variant Â  Kissing Face With Closed Eyes Emoji Kissing Cat Face With Closed Eyes approved Unicode 6.0 2010	ğŸ˜½	1
The flag Rwanda letters Â  RW Â  platforms The Flag Rwanda emoji sequence Regional Indicato	ğŸ‡·ğŸ‡¼	1
A person arms head making â€˜ OK â€™ sign circle body Intended gender neutral shown  	ğŸ™†	1
Prescription glasses shown variety frames depending platform Glasses approved Unicode 6.0 2010 n	ğŸ‘“	1
The Flag Cocos Islands emoji sequence Regional Indicator Symbol LetÂ­ter C Regional Indicator Symbol LetÂ­ter C emoj	ğŸ‡¨ğŸ‡¨	1
Pieces sushi generally Â  displayed raw fish rice Sushi approved Unicode 6.0 2010 added Emoji 1.0 2015  	ğŸ£	1
The face monkey Similar monkey emoji showing head entire body Monkey Face approved U	ğŸµ	1
A happy smiling face Â  big open mouth showing teeth Differs slightly Â  Smiling Face With Open Mouth Â  emoji fact t	ğŸ˜„	1
This emoji kissing looks like whistling emoji blowing air A bit â€˜ innocent I pretending I anythin	ğŸ˜—	1
An Â  tropical flavored drink usually served straw garnish Â  cocktail umbrella May referred tiki drink Â  boat drink u	ğŸ¹	1
A cloud small snowflakes drifting Cloud With Snow approved Unicode 7.0 2014 added Emoji 1.0 2015  	ğŸŒ¨	1
The flag Â  Moldova letters Â  MD Â  platforms The Flag Moldova emoji sequence Regional Indica	ğŸ‡²ğŸ‡©	1
The flag Â  East Timor letters Â  TL Â  platforms The Flag Timor Leste emoji sequence Regional	ğŸ‡¹ğŸ‡±	1
Similar monorail suspension railway elevated vehicle suspended track Suspension Railway approved pa	ğŸšŸ	1
The Flag St. Vincent Grenadines emoji sequence Regional Indicator Symbol LetÂ­ter V Regional Indicator Symbol Let	ğŸ‡»ğŸ‡¨	1
An Aerial Tramway commonly seen ski resorts transport locations mountain Can tourist attractio	ğŸš¡	1
This version Flexed Biceps emoji Medium dark Skin Tone applied displayed Dark Brown Skin Tone support	ğŸ’ªğŸ¾	1
A regular computer printer shown platforms gray silver color Generally plugs desktop computer Printer approved	ğŸ–¨	1
White Circle approved Unicode 4.1 2005 â€œ Medium White Circle â€ added Emoji 1.0 2015 Copy paste	âšª	1
A toilet Â  deposit Toilet approved Unicode 6.0 2010 added Emoji 1.0 2015 Copy	ğŸš½	1
An office Â  trash known Â  waste paper basket bin wastebasket Shown wire mesh platforms LG	ğŸ—‘	1
This version Princess emoji Dark Skin Tone applied displayed Black Skin Tone supported platforms Cop	ğŸ‘¸ğŸ¿	1
A custard dessert crÃ¨me caramel Â  flan layer caramel Custard approved Unicode 6.0 2010	ğŸ®	1
This version OK Hand emoji Medium light Skin Tone applied displayed Cream White Skin Tone supported p	ğŸ‘ŒğŸ¼	1
The flag Bhutan letters Â  BT Â  platforms The Flag Bhutan emoji sequence Regional Indicato	ğŸ‡§ğŸ‡¹	1
A cute hamster pink ears orange half face white gray face Has whiskers H	ğŸ¹	1
A conventional claw hammer Â  Displays Â  claw nail removal Previously displayed gavel Â  iOS changing appe	ğŸ”¨	1
A sly smile sexual smug connotation Not confused unamused face similar eyes displea	ğŸ˜	1
A Â  human skull Not confused skull crossbones emoji Skull approved Unicode 6.0 2010 added Emoji  	ğŸ’€	1
A love hotel hotel hired hour instead accommodation evening Can Â  mistaken soon emoj	ğŸ©	1
A red triangular Â  flag shown sitting Â  hole golf course green Some versions emoji include golf balls Android previo	â›³	1
An icon outlined sun decreasing Â  brightness screen Â  Appears smaller Â  Â  High Â  Brightness Symbol Dim Button  	ğŸ”…	1
The flag Saudi Arabia letters Â  SA Â  platforms The Flag Saudi Arabia emoji sequence Regio	ğŸ‡¸ğŸ‡¦	1
The cat variant Â  Crying Face Emoji Crying Cat Face approved Unicode 6.0 2010 added Emoji 1.0 2015 Copy	ğŸ˜¿	1
A school bag Emoji called satchel children attending school carry books lunch personal belongings School Ba	ğŸ’	1
An ambulance transport patients home hospital Ambulance approved Unicode 6.0 2010 adde	ğŸš‘	1
This version Man emoji Light Skin Tone applied displayed Pale Skin Tone supported platforms Copy	ğŸ‘¨ğŸ»	1
A synague place worship followers Judaism Displayed Star David Synagogue approved Unico	ğŸ•	1
A hockey stick puck sport ice hockey Not confused field hockey stick ball Ice Hockey approved	ğŸ’	1
A ballot box shown slot voting purposes A ballot shown inserted box On platforms ballot  	ğŸ—³	1
A computer peripheral Â  alternative trackpad mouse Trackball approved Unicode 7.0 2014	ğŸ–²	1
Meat bone classic cartoon like style seen manga anime Â  Known â€œ Ano Niku â€ meaning â€œ That Meat Manga Anime â€œ m	ğŸ–	1
A grimace emoji showing bared teeth usually mistake unfavorable situation arisen â€“ aka â€œ eek â€ Â  The appearance emo	ğŸ˜¬	1
The flag Colombia letters Â  CO Â  platforms The Flag Colombia emoji sequence Regional Indi	ğŸ‡¨ğŸ‡´	1
A type antenna transmission data Often associated satellite television internet Satellite Antenna approved  	ğŸ“¡	1
An icon representing vibration mode mobile phone Â  Â  silent alternative notification sounds Appears like phone hear	ğŸ“³	1
This version Person Gesturing NO emoji Medium light Skin Tone applied displayed Cream White Skin Tone	ğŸ™…ğŸ¼	1
A sad face frowning mouth disappointed Â  eyes Not confused Â  pensive face Â  remorseful Disappointed Face	ğŸ˜	1
A heart vibration movement lines indicating beating heart This emoji Â  beating heart representin	ğŸ’“	1
A push pin Â  pinning notes Â  notice board Pushpin approved Unicode 6.0 2010 added Emoji 1.0 2015 Co	ğŸ“Œ	1
The flag Â  Luxembourg letters Â  LU Â  platforms The Flag Luxembourg emoji sequence Regional I	ğŸ‡±ğŸ‡º	1
Card File Box approved Unicode 7.0 2014 added Emoji 1.0 2015 Copy paste emoji Copy	ğŸ—ƒ	1
An Â  extra terrestrial alien head Â  stereotypical depiction alien bald head large open eyes mouth iOS displays  	ğŸ‘½	1
A type cards known hanafuda cards Japan Â  range different games require associating pictures Â   	ğŸ´	1
The flag Gibraltar letters Â  GI Â  platforms The Flag Gibraltar emoji sequence Regional In	ğŸ‡¬ğŸ‡®	1
A single slice piece Â  shortcake â€“ likely strawberry peach This emoji Â  birthday greetings Â  vari	ğŸ°	1
Bags Â  items Â  purchased shopping May contain groceries clothing consumer items Shopping Bags approved o	ğŸ›	1
The flag Â  Tonga letters Â  TO Â  platforms The Flag Tonga emoji sequence Regional Indicator  	ğŸ‡¹ğŸ‡´	1
Twelve Oâ€™clock approved Unicode 6.0 2010 â€œ Clock Face Twelve O'Clock â€ added Emoji 1.0 2015 Copy	ğŸ•›	1
This version Person Mountain Biking emoji Light Skin Tone applied displayed Pale Skin Tone supported  	ğŸšµğŸ»	1
A bowl rice steamed ready served alongside delicious meal Popular Asian cuisine Cooked Rice approved Uni	ğŸš	1
A palm tree commonly found tropical warm climates Often represents vacation holiday destination Palm Tree appro	ğŸŒ´	1
This version Person Taking Bath emoji Dark Skin Tone applied displayed Black Skin Tone supported plat	ğŸ›€ğŸ¿	1
A family fathers daughter son The Family Man Man Girl Boy emoji sequence Man Man Girl	ğŸ‘¨â€ğŸ‘¨â€ğŸ‘§â€ğŸ‘¦	1
This version Man With Chinese Cap emoji Light Skin Tone applied displayed Pale Skin Tone supported pl	ğŸ‘²ğŸ»	1
A castle style Â  found France Â  parts Europe Castle approved Unicode 6.0 2010 nam	ğŸ°	1
A man Â  woman Â  holding hands likely relationship Man Woman Holding Hands approved Unicode 6.0	ğŸ‘«	1
The flag Guatemala letters Â  GT Â  platforms The Flag Guatemala emoji sequence Regional In	ğŸ‡¬ğŸ‡¹	1
The oval ball game American football known gridiron countries American Football approved Unicode  	ğŸˆ	1
The flag Â  Jordan letters Â  JO Â  platforms The Flag Jordan emoji sequence Regional Indicato	ğŸ‡¯ğŸ‡´	1
The flag Â  Liberia letters Â  LR Â  platforms The Flag Liberia emoji sequence Regional Indica	ğŸ‡±ğŸ‡·	1
A leaf clover known shamrock Commonly St Patrick Day Ireland world said	â˜˜	1
The flag Â  Montenegro letters Â  ME Â  platforms The Flag Montenegro emoji sequence Regional I	ğŸ‡²ğŸ‡ª	1
A microphone Â  amplify person voice speaking singing Shown music notes platforms implying fo	ğŸ¤	1
This version Open Hands emoji Medium light Skin Tone applied displayed Cream White Skin Tone supporte	ğŸ‘ğŸ¼	1
The flag Senegal letters Â  SN Â  platforms The Flag Senegal emoji sequence Regional Indica	ğŸ‡¸ğŸ‡³	1
A person cyclist rides mountain bike type road bicycle Â  Intended gender neutral Person Mountain Biking approved	ğŸšµ	1
A tree people use attach pieces paper containing good wishes Often spiritual religious reasons cultures Ta	ğŸ‹	1
A ladybug emoji colloquial coccinellidae family small beetles Known ladybird lad beetle countries Dis	ğŸ	1
This version Folded Hands emoji Dark Skin Tone applied displayed Black Skin Tone supported platforms	ğŸ™ğŸ¿	1
This version Boy emoji Medium Skin Tone applied displayed Moderate Brown Skin Tone supported platform	ğŸ‘¦ğŸ½	1
A small flame yellow red Can describe Â  hot context exemplar	ğŸ”¥	1
A face shown thermometer presumed Â  feeling sick May patient hospital common cold Differs  	ğŸ¤’	1
A battery battery indicator Battery approved Unicode 6.0 2010 added Emoji 1.0 2015 Copy paste emo	ğŸ”‹	1
A person swinging golf club attempting hit golf ball flag Â  green Person Golfing approved Unicode 7	ğŸŒ	1
This police officer wears blue hat features Â  gold badge shield middle The gender emoji specified	ğŸ‘®	1
A symbol showing lowercase letters b c d. Intended software keyboard input screen Â  Â  toggle lowercase Â  	ğŸ”¡	1
The flag Â  Macau letters Â  MO Â  platforms The Flag Macau emoji sequence Regional Indicator  	ğŸ‡²ğŸ‡´	1
A mushroom emoji vegetable looks similar toadstool Mushroom approved Unicode 6.0 2010 added Emoji 1.0	ğŸ„	1
This version Princess emoji Medium dark Skin Tone applied displayed Dark Brown Skin Tone supported pl	ğŸ‘¸ğŸ¾	1
A going walk Taking slow medium pace person runner picked speed This emoji intended gen	ğŸš¶	1
Index finger pointing left Backhand Index Pointing Left approved Unicode 6.0 2010 â€œ White Left Point	ğŸ‘ˆ	1
A boar known wild pig Displayed brown fur Â  prominent tusks platforms Boar approved Unicode  	ğŸ—	1
Two beers clinked celebratory manner Clinking Beer Mugs approved Unicode 6.0 2010 added Emoji  	ğŸ»	1
A record icon displayed circle Record Button approved Unicode 7.0 2014 â€œ Black Circle Record â€	âº	1
Two Japanese Imperial Dolls displayed March 3 Hina matsuri Dolls Day Girls Day These dolls intended shown Prince  	ğŸ	1
A fallen leaf Â  leaves seen season fall autumn Fallen Leaf approved Unicode 6.0 2010 add	ğŸ‚	1
This version Person Running emoji Light Skin Tone applied displayed Pale Skin Tone supported platform	ğŸƒğŸ»	1
A block chocolate shown squares foil wrapper Chocolate Bar approved Unicode 6.0 2010 added Emoji 1.0	ğŸ«	1
A formula style racing car Racing Car approved Unicode 7.0 2014 added Emoji 1.0 2015 Copy paste e	ğŸ	1
A snowman emoji snow usually children winter The Â  Snowman Without Snow Â  indicates snowing sno	â›„	1
This version Person Raising Hand emoji Medium light Skin Tone applied displayed Cream White Skin Tone	ğŸ™‹ğŸ¼	1
A bee emoji buzzing air Shown yellow black stripes light colored wings Platforms vary depiction  	ğŸ	1
A person shrugging shoulders indicate lack knowledge particular topic lack care result situati	ğŸ¤·	1
This version Person Tipping Hand emoji Dark Skin Tone applied displayed Black Skin Tone supported pla	ğŸ’ğŸ¿	1
A face big open grinning mouth showing teeth Â  Differs slightly Â  Smiling Face With Open Mouth And Smiling Eyes Â   	ğŸ˜€	1
This version Horse Racing emoji Medium light Skin Tone applied displayed Cream White Skin Tone suppor	ğŸ‡ğŸ¼	1
An ancient scroll papyrus Â  shorter versions known roll The Apple version emoji contains following words Here	ğŸ“œ	1
The Flag Pitcairn Islands emoji sequence Regional Indicator Symbol LetÂ­ter P Regional Indicator Symbol LetÂ­ter N e	ğŸ‡µğŸ‡³	1
A colorful party popper Â  party celebration Appears conical party hat streamers confetti bursting	ğŸ‰	1
The flag Haiti letters Â  HT Â  platforms The Flag Haiti emoji sequence Regional Indicator  	ğŸ‡­ğŸ‡¹	1
This version Man With Chinese Cap emoji Medium Skin Tone applied displayed Moderate Brown Skin Tone s	ğŸ‘²ğŸ½	1
Spiral Notepad approved Unicode 7.0 2014 â€œ Spiral Note Pad â€ added Emoji 1.0 2015 Copy paste t	ğŸ—’	1
Two men Â  holding hands likely relationship Two Men Holding Hands approved Unicode 6.0 2010 add	ğŸ‘¬	1
A pretty rainbow emoji clear Â  sky tends appear light rain mist air time sunshine Th	ğŸŒˆ	1
A Â  human mouth displayed lips instead mouth Mouth approved Unicode 6.0 2010 added Emoji	ğŸ‘„	1
A pause icon displayed vertical bars Pause Button approved Unicode 7.0 2014 â€œ Double Vertical Bar â€  	â¸	1
This version Girl emoji Medium light Skin Tone applied displayed Cream White Skin Tone supported plat	ğŸ‘§ğŸ¼	1
A Â  classic smiley face emoji Â  Â  open mouth showing teeth tall Â  open eyes Â  Differs slightly Â  Smiling Face With Open Mou	ğŸ˜ƒ	1
The flag Â  Myanmar letters Â  MM Â  platforms The Flag Myanmar emoji sequence Regional Indica	ğŸ‡²ğŸ‡²	1
This version Person Getting Massage emoji Medium light Skin Tone applied displayed Cream White Skin Tone	ğŸ’†ğŸ¼	1
The flag Hong Kong letters Â  HK Â  platforms The Flag Hong Kong emoji sequence Regional In	ğŸ‡­ğŸ‡°	1
A optical disc common types CD DVD Can store computer files Â  distribution music	ğŸ’¿	1
This version Thumbs Down emoji Medium light Skin Tone applied displayed Cream White Skin Tone support	ğŸ‘ğŸ¼	1
The Flag St. Lucia emoji sequence Regional Indicator Symbol LetÂ­ter L Regional Indicator Symbol LetÂ­ter C emojis  	ğŸ‡±ğŸ‡¨	1
No Smoking approved Unicode 6.0 2010 â€œ No Smoking Symbol â€ added Emoji 1.0 2015 Copy paste thi	ğŸš­	1
The world showing North South America Globe Showing Americas approved Unicode 6.0 2010 â€œ Earth Globe A	ğŸŒ	1
This version Raising Hands emoji Dark Skin Tone applied displayed Black Skin Tone supported platforms	ğŸ™ŒğŸ¿	1
Bars increasing height showing strength mobile cellular phone Â  signal More bars signifies better reception Antenna Bars wa	ğŸ“¶	1
A man dressed formal occassion wearing tuxedo This emoji gender pair bride emoji Man Tuxedo app	ğŸ¤µ	1
This version Thumbs Up emoji Medium dark Skin Tone applied displayed Dark Brown Skin Tone supported p	ğŸ‘ğŸ¾	1
A pair eyes glancing slightly left platforms Â  The Google version emoji previously Â  showed single eye despi	ğŸ‘€	1
The flag American Samoa letters AS platforms The Flag American Samoa emoji sequence R	ğŸ‡¦ğŸ‡¸	1
A Â  jockey riding horse Â  horse race Shown riding left screen major platforms Emoji modifiers change skin tone  	ğŸ‡	1
This version Woman Dancing emoji Medium Skin Tone applied displayed Moderate Brown Skin Tone supporte	ğŸ’ƒğŸ½	1
This version Thumbs Down emoji Medium dark Skin Tone applied displayed Dark Brown Skin Tone supported	ğŸ‘ğŸ¾	1
The flag Estonia letters Â  EE Â  platforms The Flag Estonia emoji sequence Regional Indica	ğŸ‡ªğŸ‡ª	1
Nine Oâ€™clock approved Unicode 6.0 2010 â€œ Clock Face Nine O'Clock â€ added Emoji 1.0 2015 Copy p	ğŸ•˜	1
The flag Â  Lebanon letters Â  LB Â  platforms The Flag Lebanon emoji sequence Regional Indica	ğŸ‡±ğŸ‡§	1
The flag Faroe Islands letters Â  FO Â  platforms The Flag Faroe Islands emoji sequence Reg	ğŸ‡«ğŸ‡´	1
A Â  fingers crossed emoji Â  displays Â  Â  index finger crossed Â  middle second Â  finger Commonly gesture indicati	ğŸ¤	1
A sad face tears streaming cheeks Â  This face Â  distraught inconsolable Not confused tears joy emoji  	ğŸ˜­	1
A pensive remorseful Â  face Saddened life Quietly considering things went wrong Pensive Face approved Unicode  	ğŸ˜”	1
Ox approved Unicode 6.0 2010 added Emoji 1.0 2015 Copy paste emoji Copy	ğŸ‚	1
A fox face shown pointy ears At small sizes difficult discern wolf face Fox Face approved Unicode  	ğŸ¦Š	1
The flag Japan letters Â  JP Â  platforms The Flag Japan emoji sequence Regional Indicator  	ğŸ‡¯ğŸ‡µ	1
A spherical vessel long downward pointing neck Used distilling liquids Appears like oddly shaped Â  vase containing blue liqui	âš—	1
A heart shaded completely black May express morbidity sorrow form dark humor Not confused Â  Heavy Black  	ğŸ–¤	1
A pink love heart stars making look like sparkling shimmering Sparkling Heart approved Unicode 6	ğŸ’–	1
A tiger face displayed major platforms Â  cute cartoon Â  appearance Tiger Face approved Unicode 6.0 2010	ğŸ¯	1
Two triangles pointing right Most commonly symbol Â  fast forwarding Â  media Â  video tapes Â  CDs digital audio	â©	1
A cheeky face sticking tongue Â  jest Â  Used way stating â€œ I kidding â€ generally jovial Face With S	ğŸ˜›	1
A male face adult age Â  Differentiated Â  boy Â  emoji Android Â  lack Â  cap iOS Â  moustache Â  Difficult discer	ğŸ‘¨	1
A face halo represent angel good person person good deed Smiling Face With Halo appr	ğŸ˜‡	1
A plain t shirt worn men women Displayed blue polo shirt iOS Facebook Firefox OS A white t shirt Androi	ğŸ‘•	1
This version Backhand Index Pointing Right emoji Light Skin Tone applied displayed Pale Skin Tone sup	ğŸ‘‰ğŸ»	1
A goat displayed white gray brown depending platform Â   Previously appeared Saanen goat iOS changed Toggenberg  	ğŸ	1
A comfortable bed shown bedposts headboard Â  May found household bedroom hotel form sleeping accommodatio	ğŸ›	1
This version Person Bowing emoji Medium light Skin Tone applied displayed Cream White Skin Tone suppo	ğŸ™‡ğŸ¼	1
This version Person Mountain Biking emoji Medium Skin Tone applied displayed Moderate Brown Skin Tone	ğŸšµğŸ½	1
A small pouch size handbag purse Clutch Bag approved Unicode 6.0 2010 â€œ	ğŸ‘	1
Heavy Division Sign approved Unicode 6.0 2010 added Emoji 1.0 2015 Copy paste emoji Copy	â—	1
An insect appears caterpillar Apple Artwork centipede millipede Google Microsoft versions Bug  	ğŸ›	1
A cute bear face displayed like Â  teddy bear emoji accurate depiction real bear Bear Face approved Unicod	ğŸ»	1
The flag Â  Sweden letters Â  SE Â  platforms The Flag Sweden emoji sequence Regional Indicato	ğŸ‡¸ğŸ‡ª	1
A burrito emoji popular wrapped Â  Mexican food item Shown wrapped foil platforms Burrito approved Unicode 8.0	ğŸŒ¯	1
This version Person Wearing Turban emoji Medium light Skin Tone applied displayed Cream White Skin Tone  	ğŸ‘³ğŸ¼	1
A robot face showing metallic head Â  eyes grill like mouth similar grimace Was available Gmail prior inc	ğŸ¤–	1
A triangle shaped arrow pointing Styled similarly Â  left Â  Â  right Â  pointing triangles iOS shown red Windows o	ğŸ”½	1
A form public transport similar tram Â  running track network separated cars types traffic Difficult	ğŸšˆ	1
Santa Claus known countries Father Christmas brings joy children Christmas Â  time Married Mrs Claus The Santa emoji ha	ğŸ…	1
Articulated Lorry approved Unicode 6.0 2010 added Emoji 1.0 2015 Copy paste emoji Copy	ğŸš›	1
A yellow colored fruit known sour Â  taste Shown green leaves platforms Has relation Bey	ğŸ‹	1
A decorated Christmas Tree emoji pine tree displayed Christmas time usually adorned lights tinsel ornaments Â  Presents	ğŸ„	1
A raised hand finger thumb Held manner indicate number Similar waving hand	ğŸ–	1
A crayon displays colors depending platform Consistently shown 225 Â° angle Not confused Â  Lower Left  	ğŸ–	1
A person dropping litter rubbish trash red stroke indicating littering prohibited area Usually implie	ğŸš¯	1
This version Thumbs Down emoji Dark Skin Tone applied displayed Black Skin Tone supported platforms  	ğŸ‘ğŸ¿	1
A family fathers Â  daughter The Family Man Man Girl emoji sequence Man Man Girl emojis These  	ğŸ‘¨â€ğŸ‘¨â€ğŸ‘§	1
This version Santa Claus emoji Light Skin Tone applied displayed Pale Skin Tone supported platforms  	ğŸ…ğŸ»	1
A chart showing figures decreasing Â  time downward Â  trend A type line graph Chart Decreasing approved Unicode	ğŸ“‰	1
A tractor farmer occupation land Tractor approved Unicode 6.0 2010 added Emoji 1	ğŸšœ	1
Desert Island approved Unicode 7.0 2014 added Emoji 1.0 2015 Copy paste emoji Copy	ğŸ	1
A speaker red line indicating muted volume silencing Â  audio Muted Speaker approved Unicode 6.0 20	ğŸ”‡	1
This version Old Woman emoji Medium light Skin Tone applied displayed Cream White Skin Tone supported	ğŸ‘µğŸ¼	1
A television set Â  display Â  broadcasts air terrestrial Can Â  screen input sources	ğŸ“º	1
A delicious donut emoji spelled doughnut British English Generally displayed chocolate coated Â  doughnut colored sprinkles	ğŸ©	1
A school building multiple storeys clock A place children teenagers attend education Displays  	ğŸ«	1
Raindrops falling cloud sun shown background half covered cloud The combination sun rain cause  	ğŸŒ¦	1
A person checking passports international border Passport Control approved Unicode 6.0 2010 added Emoji 1.0  	ğŸ›‚	1
A face shown single finger thumb resting chin glancing upward Used indicate thinking deep thought Can paired  	ğŸ¤”	1
A person blond hair Â  tends appear yellow Displayed Â  man platforms emoji keeps blond hair matter  	ğŸ‘±	1
A popular form transferring files 1980s 1990s This 3.5 inch variant floppy disk hard outer shell	ğŸ’¾	1
This version Woman Dancing emoji Medium light Skin Tone applied displayed Cream White Skin Tone suppo	ğŸ’ƒğŸ¼	1
This version Guard emoji Light Skin Tone applied displayed Pale Skin Tone supported platforms Copy	ğŸ’‚ğŸ»	1
The flag Â  Namibia letters Â  NA Â  platforms The Flag Namibia emoji sequence Regional Indica	ğŸ‡³ğŸ‡¦	1
The flag Â  Somalia letters Â  SO Â  platforms The Flag Somalia emoji sequence Regional Indica	ğŸ‡¸ğŸ‡´	1
The flag Ethiopia letters Â  ET Â  platforms The Flag Ethiopia emoji sequence Regional Indi	ğŸ‡ªğŸ‡¹	1
This version Ear emoji Medium light Skin Tone applied displayed Cream White Skin Tone supported platf	ğŸ‘‚ğŸ¼	1
The world showing Europe Africa Globe Showing Europe Africa approved Unicode 6.0 2010 â€œ Earth Globe Eu	ğŸŒ	1
Delivery Truck approved Unicode 6.0 2010 added Emoji 1.0 2015 Copy paste emoji Copy	ğŸšš	1
This version Person Swimming emoji Medium Skin Tone applied displayed Moderate Brown Skin Tone suppor	ğŸŠğŸ½	1
A water tap red stroke indicating Â  water safe drinking non potable May camp site  	ğŸš±	1
A slice Â  pizza pepperoni topping The Android pizza emoji Â  includes Â  slice green pepper capsicum How exotic P	ğŸ•	1
ON Arrow approved Unicode 6.0 2010 â€œ On With Exclamation Mark With Left Right Arrow Above â€ added Emo	ğŸ”›	1
This version Ear emoji Dark Skin Tone applied displayed Black Skin Tone supported platforms Copy	ğŸ‘‚ğŸ¿	1
An index file containing list information small printed cards Commonly displaying Â  contacts contact details Th	ğŸ“‡	1
A Â  symbol planet earth showing lines Â  longitude latitude Commonly icon internationalization features Â  iOS	ğŸŒ	1
An ear corn known maize countries world Ear Corn approved Unicode 6.0 2010	ğŸŒ½	1
A bus public transport cities towns Could school bus Bus approved Unicode 6.0 2010	ğŸšŒ	1
A latin cross known Christian cross This cross symbol symbol Christianity Similar appearance Â  t	âœ	1
No Entry approved Unicode 5.2 2009 added Emoji 1.0 2015 Copy paste emoji Copy	â›”	1
A set red orange amber green traffic lights intersections Â  More common horizontal traffic light Vertical Traffi	ğŸš¦	1
A cake lit candles middle created birthday The Apple version features strawberries decoration flavour G	ğŸ‚	1
White Exclamation Mark approved Unicode 6.0 2010 â€œ White Exclamation Mark Ornament â€ added Emoji 1.0	â•	1
A triangular red flag post Â  Most commonly associated golf shown Â  Â  flag hole emoji Triangular Flag approved par	ğŸš©	1
A trumpet brass instrument played jazz bands Trumpet approved Unicode 6.0 2010 added Emoji 1.0 2015 Copy	ğŸº	1
This version Backhand Index Pointing Up emoji Medium dark Skin Tone applied displayed Dark Brown Skin To	ğŸ‘†ğŸ¾	1
Male royalty intended gender pair princess emoji Shown man crown Prince approved Unicode 9.0 2	ğŸ¤´	1
Index finger pointing upward showing hand Backhand Index Pointing Up approved Unicode 6.0	ğŸ‘†	1
A night sky stars depicted major platforms cityscape night Night With Stars approved Unicode 6.0 2010	ğŸŒƒ	1
A family father mother daughter son The Family Man Woman Girl Boy emoji sequence Man Woman Girl	ğŸ‘¨â€ğŸ‘©â€ğŸ‘§â€ğŸ‘¦	1
This version Raised Fist emoji Light Skin Tone applied displayed Pale Skin Tone supported platforms C	âœŠğŸ»	1
A symbol representing accommodation hostel hotel bed breakfast place sleep Shown platforms person  	ğŸ›Œ	1
100 emoji number written red underlined twice emphasis Originating number 100 Â  written school exam o	ğŸ’¯	1
A tear calendar featuring single day ring binders changing dates Not confused Calendar emoji	ğŸ“†	1
A couple standing smiling pink love heart floating air Generally displayed woman Â  m	ğŸ’‘	1
A police car shown emergency light This emoji displayed opposed oncoming police car emoji  	ğŸš“	1
The flag Â  Latvia letters Â  LV Â  platforms The Flag Latvia emoji sequence Regional Indicato	ğŸ‡±ğŸ‡»	1
A cocktail glass thin stem wide surface area Often associated martinis Â  versions emoji Â  Â  olive inside t	ğŸ¸	1
The flag Costa Rica letters Â  CR Â  platforms The Flag Costa Rica emoji sequence Regional  	ğŸ‡¨ğŸ‡·	1
A single tulip emoji Commonly Â  seen tulip festivals Â  locations world Â  dutch heritage Tulip approved Un	ğŸŒ·	1
The flag Â  Angola letters A O platforms The Flag Angola emoji sequence Regional Ind	ğŸ‡¦ğŸ‡´	1
This version Person Swimming emoji Light Skin Tone applied displayed Pale Skin Tone supported platfor	ğŸŠğŸ»	1
A Â  human skull shown crossed pair bones Used symbol death danger warning poisenous substances Â  Not  	â˜ 	1
A Domestic Water Buffalo primarily tilling ploughing rice fields parts Asia Water Buffalo approved Unicode	ğŸƒ	1
The flag Guinea letters Â  GN Â  platforms The Flag Guinea emoji sequence Regional Indicato	ğŸ‡¬ğŸ‡³	1
Called â€œ No Entry â€ sign Emoji look like entry road sign expect The artwork Emoji looks l	ğŸš«	1
The flag Â  United States Â  America USA letters Â  US Â  platforms The Flag United States emoji s	ğŸ‡ºğŸ‡¸	1
The flag Â  Vatican City letters Â  VA Â  platforms The Flag Vatican City emoji sequence Regio	ğŸ‡»ğŸ‡¦	1
A face upside representing sense silliness goofiness Sometimes ambiguous emotion joking sar	ğŸ™ƒ	1
A pile cash notes US Dollar Bills Apple artwork money clip wings attached The money flying away Money	ğŸ’¸	1
This version Person Walking emoji Medium light Skin Tone applied displayed Cream White Skin Tone supp	ğŸš¶ğŸ¼	1
The cat variant Â  Smiling Face With Heart Shaped Eyes Emoji No knows need cat variant Smiling Cat Face With Hear	ğŸ˜»	1
A face shown drool dripping mouth May display Â  desire person object concept Not co	ğŸ¤¤	1
The Flag CÃ´te Dâ€™Ivoire emoji sequence Regional Indicator Symbol LetÂ­ter C Regional Indicator Symbol LetÂ­ter I emoj	ğŸ‡¨ğŸ‡®	1
A raised hand fingers separated ring finger middle finger Vulcan Salute approved Unicode 7.0	ğŸ––	1
A graduation cap worn head students graduating college university Known locations mortar board tassel	ğŸ“	1
A character lying floor extreme laughter Face laughing possibly hand hitting floor Â  An emoji ve	ğŸ¤£	1
A single drop water blue liquid May single drop sweat Droplet approved Unicode 6.0 2010	ğŸ’§	1
Lipstick Â  shown Â  lid removed Displays shade red platforms Android pink color Lipstick appro	ğŸ’„	1
A love Â  heart broken This emoji represents aching feels missing Â  person love Broken Heart approv	ğŸ’”	1
The flag CuraÃ§ao letters Â  CW Â  platforms The Flag CuraÃ§ao emoji sequence Regional Indica	ğŸ‡¨ğŸ‡¼	1
A loudspeaker announcements public areas schools sporting grounds Loudspeaker approved Unicode 6	ğŸ“¢	1
A personal computer Â  commonly shown Â  laptop Â  computer Â  Some systems display desktop computer mouse This emoji prev	ğŸ’»	1
A fish emoji swimming non tropical climate Fish approved Unicode 6.0 2010 added Emoji 1.0 2015 Copy  	ğŸŸ	1
Three Oâ€™clock approved Unicode 6.0 2010 â€œ Clock Face Three O'Clock â€ added Emoji 1.0 2015 Copy	ğŸ•’	1
This version Nail Polish emoji Dark Skin Tone applied displayed Black Skin Tone supported platforms  	ğŸ’…ğŸ¿	1
A rock Â  hand gesture raising pinky index fingers hand variety Â  meanings Sign Horns approved  	ğŸ¤˜	1
The flag Â  Western Sahara letters Â  EH Â  platforms The Flag Western Sahara emoji sequence R	ğŸ‡ªğŸ‡­	1
This version Princess emoji Medium Skin Tone applied displayed Moderate Brown Skin Tone supported pla	ğŸ‘¸ğŸ½	1
Passenger Ship approved Unicode 7.0 2014 added Emoji 1.0 2015 Copy paste emoji Copy	ğŸ›³	1
The flag Â  Suriname letters Â  SR Â  platforms The Flag Suriname emoji sequence Regional Indi	ğŸ‡¸ğŸ‡·	1
A face showing bandage wrapped head Used injured Differs face thermometer	ğŸ¤•	1
A fist raised air celebratory gesture fist pump Â  Can represent zero items lack finger	âœŠ	1
This emoji means â€œ â€ Japanese usually denote â€œ capacity â€ gas petrol tank car pre paid phone card CJK I	ğŸˆµ	1
A beautiful view featuring orange sky sun setting buildings city skyline Sunset approved Unicode	ğŸŒ‡	1
This version Thumbs Up emoji Light Skin Tone applied displayed Pale Skin Tone supported platforms Co	ğŸ‘ğŸ»	1
Film Projector approved Unicode 7.0 2014 added Emoji 1.0 2015 Copy paste emoji Copy	ğŸ“½	1
A lollipop circular candy stick Shown variety colors rainbow Apple devices yellow pink Android pink Window	ğŸ­	1
A person juggling colored balls The person shown emoji generally appearance man wears ha	ğŸ¤¹	1
A British guardsman known foot guard Wears tall black hat yellow chin strap Must look straight ahead times whe	ğŸ’‚	1
A Â  thumbs gesture indicating disapproval Thumbs Down approved Unicode 6.0 2010 â€œ Thumbs Down Sign â€  	ğŸ‘	1
The flag US Virgin Islands letters Â  VI Â  platforms The Flag U.S. Virgin Islands emoji sequence  	ğŸ‡»ğŸ‡®	1
Boo A ghost emoji trying scare Might halloween costume Ghost approved Unicode 6.0 2010 added  	ğŸ‘»	1
The flag Belize letters Â  BZ Â  platforms The Flag Belize emoji sequence Regional Indicato	ğŸ‡§ğŸ‡¿	1
A generic high rise office building Generally found cities active business hours The office building shown Twemoji	ğŸ¢	1
A face displayed open hands gesture offering hug Hugging Face approved Unicode 8.0 2015 added Emoji 1.0	ğŸ¤—	1
A face zipper displayed instead mouth Used convey secret discuss certain matter aka â€œ m	ğŸ¤	1
A type monster creature feature arcade video games Often assumed alien Â  varying appearances	ğŸ‘¾	1
An exhausted looking face Â  open mouth tightly closed eyes Â  On platforms emoji similar appearance Â  Weary Fac	ğŸ˜«	1
END Arrow approved Unicode 6.0 2010 â€œ End With Leftwards Arrow Above â€ added Emoji 1.0 2015 Copy	ğŸ”š	1
A cheeky looking monkey sitting tail curled Monkey approved Unicode 6.0 2010 added Emoji 1.0 2015	ğŸ’	1
This version Person Pouting emoji Medium dark Skin Tone applied displayed Dark Brown Skin Tone suppor	ğŸ™ğŸ¾	1
CL shows CLear button older mobile phones CL Button approved Unicode 6.0 2010 â€œ Squa	ğŸ†‘	1
This version Person Getting Massage emoji Dark Skin Tone applied displayed Black Skin Tone supported  	ğŸ’†ğŸ¿	1
A large red cross mark displayed shape letter X similar multiplication sign Cross Mark approved Unicod	âŒ	1
This version Oncoming Fist emoji Medium light Skin Tone applied displayed Cream White Skin Tone suppo	ğŸ‘ŠğŸ¼	1
An information desk person iconically represented Apple emoji artwork Â  girl holding hand Â  waitress carry	ğŸ’	1
A face smiling wearing dark sunglasses Â  denote sense cool The nerd face emoji similar face Â  regular g	ğŸ˜	1
The flag Guernsey letters Â  GG Â  platforms The Flag Guernsey emoji sequence Regional Indi	ğŸ‡¬ğŸ‡¬	1
An ornate old key lock items chest wardrobe Old Key approved Unicode 7.0 2014 adde	ğŸ—	1
Clockwise Vertical Arrows approved Unicode 6.0 2010 â€œ Clockwise Downwards Upwards Open Circle Arrows â€	ğŸ”ƒ	1
The Flag Palestinian Territories emoji sequence Regional Indicator Symbol LetÂ­ter P Regional Indicator Symbol LetÂ­	ğŸ‡µğŸ‡¸	1
New Moon approved Unicode 6.0 2010 â€œ New Moon Symbol â€ added Emoji 1.0 2015 Copy paste em	ğŸŒ‘	1
This version Person Raising Hand emoji Medium Skin Tone applied displayed Moderate Brown Skin Tone su	ğŸ™‹ğŸ½	1
Heavy Plus Sign approved Unicode 6.0 2010 added Emoji 1.0 2015 Copy paste emoji Copy	â•	1
Chains approved Unicode 5.2 2009 added Emoji 1.0 2015 Copy paste emoji Copy	â›“	1
A volcano erupting smoke lava Volcano approved Unicode 6.0 2010 added Emoji 1.0 2015 Copy paste  	ğŸŒ‹	1
A high speed train designed cover long distances high speed Also features streamlined bullet nose reference  	ğŸš…	1
A crescent moon shape showing face looking left First Quarter Moon With Face approved Unicode 6.0 2010 added Em	ğŸŒ›	1
Hammer Wrench approved Unicode 7.0 2014 added Emoji 1.0 2015 Copy paste emoji Copy	ğŸ› 	1
The flag Â  Ã…land Islands Â  letters Â  AX Â  platforms The Flag Ã…land Islands emoji sequence Reg	ğŸ‡¦ğŸ‡½	1
A family Â  fathers Â  Â  sons The Family Man Man Boy Boy emoji sequence Man Man Boy Boy emojis	ğŸ‘¨â€ğŸ‘¨â€ğŸ‘¦â€ğŸ‘¦	1
The flag Â  Jersey letters Â  JE Â  platforms The Flag Jersey emoji sequence Regional Indicato	ğŸ‡¯ğŸ‡ª	1
The flag Finland letters Â  FI Â  platforms Finnish Flag Emoji The Flag Finland emoji sequence o	ğŸ‡«ğŸ‡®	1
A family unit commonly represented father mother children Family approved Unicode 6.0 201	ğŸ‘ª	1
A person arms forming â€˜ X â€™ indicate â€˜ â€™ â€˜ good â€™ This motion TV game Deal No Deal indicate â€˜ N	ğŸ™…	1
A blue heart emoji Blue Heart approved Unicode 6.0 2010 added Emoji 1.0 2015 Copy paste emoji Copy	ğŸ’™	1
An emoji representing cinema Â  large screen showing latest movies available public Displayed Apple Twitter fil	ğŸ¦	1
A form speech balloon angular edges denote angry speech comics Right Anger Bubble approved Unicode  	ğŸ—¯	1
A frowning face Â  unhappy mouth curving downward This face Â  extreme version Â  slightly frowning face See glossary  	â˜¹	1
This version Blond haired Person emoji Light Skin Tone applied displayed Pale Skin Tone supported pla	ğŸ‘±ğŸ»	1
White Question Mark approved Unicode 6.0 2010 â€œ White Question Mark Ornament â€ added Emoji 1.0 2015	â”	1
A ripe avocado cut open ready served Displayed Â  cut half stone showing Avocado approved Unicode 9.0  	ğŸ¥‘	1
The flag Bouvet Island letters Â  BV Â  platforms Â  This flag Norway The Flag Bouvet Island  	ğŸ‡§ğŸ‡»	1
The flag Philippines letters Â  PH Â  platforms The Flag Philippines emoji sequence Regiona	ğŸ‡µğŸ‡­	1
The flag Â  Israel letters Â  IL Â  platforms The Flag Israel emoji sequence Regional Indicato	ğŸ‡®ğŸ‡±	1
A person pouting Outwardly showing displeasure situation Â  This shows person pouting face	ğŸ™	1
The flag Germany letters Â  DE Â  platforms The Flag Germany emoji sequence Regional Indicat	ğŸ‡©ğŸ‡ª	1
This version Person Wearing Turban emoji Medium Skin Tone applied displayed Moderate Brown Skin Tone  	ğŸ‘³ğŸ½	1
Pick approved Unicode 5.2 2009 added Emoji 1.0 2015 Copy paste emoji Copy	â›	1
A steaming bowl food Displayed bowl Â  ramen noodles emoji artwork definition bowl containing hot	ğŸœ	1
Mother Christmas commonly known Mrs Claus outside United Kingdom Â  The wife Father Christmas displayed older woman  	ğŸ¤¶	1
The flag Grenada letters Â  GD Â  platforms The Flag Grenada emoji sequence Regional Indica	ğŸ‡¬ğŸ‡©	1
An umbrella hooked handle displayed open rain drops Â  falling The color umbrella varies platform In November 2	â˜”	1
The Â  word Â  free shown enclosed Â  square FREE Button approved Unicode 6.0 2010 â€œ Squared Free â€ added t	ğŸ†“	1
A rice crop growing ground harvesting Sheaf Rice approved Unicode 6.0 2010 â€œ Ear Rice â€	ğŸŒ¾	1
This version Person Bowing emoji Medium dark Skin Tone applied displayed Dark Brown Skin Tone support	ğŸ™‡ğŸ¾	1
This version Baby emoji Light Skin Tone applied displayed Pale Skin Tone supported platforms Copy	ğŸ‘¶ğŸ»	1
Black Circle approved Unicode 4.1 2005 â€œ Medium Black Circle â€ added Emoji 1.0 2015 Copy paste	âš«	1
Question Mark approved Unicode 6.0 2010 â€œ Black Question Mark Ornament â€ added Emoji 1.0 2015 Copy	â“	1
This version Person Running emoji Dark Skin Tone applied displayed Black Skin Tone supported platform	ğŸƒğŸ¿	1
A sided die range board turn based games Commonly called Â  dice refers plural die Most platforms	ğŸ²	1
Japanese â€œ acceptable â€ Button approved Unicode 6.0 2010 â€œ Circled Ideograph Accept â€ added Emoji 1.0	ğŸ‰‘	1
Two Oâ€™clock approved Unicode 6.0 2010 â€œ Clock Face Two O'Clock â€ added Emoji 1.0 2015 Copy pas	ğŸ•‘	1
A fist pointing right conjunction Â  left facing fist Â  complete Â  fist bump Â  gesture Right facing Fist app	ğŸ¤œ	1
A spider web shown symmetrical Â  orb web shape commonly seen cartoon form Spider Web approved Unicode 7.0 2014	ğŸ•¸	1
The sun rising mountain range early morning Sunrise Over Mountains approved Unicode 6.0 2010 added  	ğŸŒ„	1
A sun rising early morning Â  Can difficult Â  distinguish sunset versions artwork Sunrise approved  	ğŸŒ…	1
A camel bumps found primarily Central Asia Much rarer single bump Dromedary Camel Two hump Camel approved	ğŸ«	1
A desktop computer shown current model iMac Apple artwork PC tower case Emoji One image Not confused  	ğŸ–¥	1
This version Raised Fist emoji Medium light Skin Tone applied displayed Cream White Skin Tone supporte	âœŠğŸ¼	1
This version Clapping Hands emoji Dark Skin Tone applied displayed Black Skin Tone supported platform	ğŸ‘ğŸ¿	1
A family Â  Â  mothers Â  Â  daughters The Family Woman Woman Girl Girl emoji sequence Woman Woman Girl	ğŸ‘©â€ğŸ‘©â€ğŸ‘§â€ğŸ‘§	1
Film Frames approved Unicode 7.0 2014 added Emoji 1.0 2015 Copy paste emoji Copy	ğŸ	1
A person process getting hair cut This emoji intended gender neutral Â  commonly shown Â  girl woman smi	ğŸ’‡	1
A crescent moon shape showing face looking right Last Quarter Moon With Face approved Unicode 6.0 2010 added Em	ğŸŒœ	1
A hand waving â€œ hello â€ â€œ goodbye â€ Waving Hand approved Unicode 6.0 2010 â€œ Waving Hand Sign â€ add	ğŸ‘‹	1
A minidisc looks like small optical disc permanent plastic case approximately size cassette tape Minidisc briefly expe	ğŸ’½	1
A plate food containing curry rice Due origins emoji Japan likely intended Japanese curry	ğŸ›	1
A bride traditional western wedding dress veil head This veil white Apple emoji pink Google emoji b	ğŸ‘°	1
Black Medium small Square approved Unicode 3.2 2002 â€œ Black Medium Small Square â€ added Emoji 1.0 2	â—¾	1
Face sad mouth worried looking eyebrows Worried Face approved Unicode 6.1 2012 added Emoji 1.0 2015	ğŸ˜Ÿ	1
One Â  wise monkeys known Â  Iwazaru This Speak No Evil monkey hands covering mouth proverb â€œ evil	ğŸ™Š	1
A yen banknote Japan Yen Banknote approved Unicode 6.0 2010 â€œ Banknote With Yen Sign â€ added Emo	ğŸ’´	1
A church building generally associated Christian denominations In addition quiet Â  prayer churches hold regular Â  worship services wedd	â›ª	1
A helicopter hover air Often seen emergency circumstances transporting patients hospital police Â  o	ğŸš	1
An arm flexing biceps muscle Represents strength working Flexed Biceps approved Unicode 6.0 2010	ğŸ’ª	1
Waning Gibbous Moon approved Unicode 6.0 2010 â€œ Waning Gibbous Moon Symbol â€ added Emoji 1.0 2015  	ğŸŒ–	1
This version Backhand Index Pointing Right emoji Medium Skin Tone applied displayed Moderate Brown Skin  	ğŸ‘‰ğŸ½	1
Wrench approved Unicode 6.0 2010 added Emoji 1.0 2015 Copy paste emoji Copy	ğŸ”§	1
A closed book reads â€œ Vol 1 John Appleseed â€ cover Apple artwork Shown pink Android orange Windows Clos	ğŸ“•	1
The flag Belarus letters Â  BY Â  platforms The Flag Belarus emoji sequence Regional Indica	ğŸ‡§ğŸ‡¾	1
This version Raised Hand emoji Light Skin Tone applied displayed Pale Skin Tone supported platforms C	âœ‹ğŸ»	1
A man wearing turban form customary headwear Â  worn Sikhs Muslims Person Wearing Turban approved Unicode 6.0  	ğŸ‘³	1
Mountain Cableway approved Unicode 6.0 2010 added Emoji 1.0 2015 Copy paste emoji Copy	ğŸš 	1
The flag Argentina letters AR platforms The Flag Argentina emoji sequence Regional In	ğŸ‡¦ğŸ‡·	1
A dog emoji appears different breeds depending platform viewed The Apple artwork shows Â  dog Â  light b	ğŸ•	1
A circular symbol commonly Â  representation peace Alternatives include Victory Hand Dove Peace Peace Symbol	â˜®	1
This version Blond haired Person emoji Dark Skin Tone applied displayed Black Skin Tone supported pla	ğŸ‘±ğŸ¿	1
Bookmark tabs stuck pages book document These indicate important sections signature action taken	ğŸ“‘	1
A house Â  unoccupied derelict In state disrepair Derelict House approved Unicode 7.0 2014 un	ğŸš	1
The flag Bahrain letters Â  BH Â  platforms The Flag Bahrain emoji sequence Regional Indica	ğŸ‡§ğŸ‡­	1
The moon shown small portion right lit Â  rest shadow Waxing Crescent Moon approved Unicode	ğŸŒ’	1
Not confused Sleeping Face Emoji sleepy face emoji features snot bubble coming nose This Â  anime	ğŸ˜ª	1
Used alternative check tick Japan correct The opposite X cross mark wrong He	â­•	1
A Â  ribbon medallion generally Â  awarded Â  Â  person military heroic acts Military Medal approved Unicode 7.0  	ğŸ–	1
A yellow taxicab Â  iconically seen Â  New York City Shown opposed Â  taxi Â  emoji displays vehicl	ğŸš–	1
This version Person Swimming emoji Dark Skin Tone applied displayed Black Skin Tone supported platfor	ğŸŠğŸ¿	1
A pretty ribbon tied bow Pink Apple devices yellow orange Android red Twitter Ribbon approved Unicode  	ğŸ€	1
This version Person Getting Haircut emoji Dark Skin Tone applied displayed Black Skin Tone supported  	ğŸ’‡ğŸ¿	1
A singlet running shirt Shown sash Running Shirt approved Unicode 6.0 2010 â€œ Running Shirt With  	ğŸ½	1
The flag Â  Mongolia letters Â  MN Â  platforms The Flag Mongolia emoji sequence Regional Indi	ğŸ‡²ğŸ‡³	1
A symbol representing Blood Type AB AB Button blood Type approved Unicode 6.0 2010 â€œ Negative Squared AB â€	ğŸ†	1
Oden Â  Japanese meal Â  egg fish cakes radish ingredients Â  Oden served Â  skewer Similar appea	ğŸ¢	1
A framed containing photograph Â  painting inside Shows variety scenes depending platform including hills mountains beac	ğŸ–¼	1
The Tokyo Tower second tallest building Japan located Â  Minato Tokyo Built 1957 design Tokyo Tower Â  inspire	ğŸ—¼	1
This version Person Walking emoji Medium Skin Tone applied displayed Moderate Brown Skin Tone support	ğŸš¶ğŸ½	1
A credit card emoji showing card magnetic strip The Apple artwork symbol shows authorised signature  	ğŸ’³	1
The sun small cloud foreground The majority sun visible See glossary information term Â  white Â  uni	ğŸŒ¤	1
This version Thumbs Up emoji Dark Skin Tone applied displayed Black Skin Tone supported platforms Co	ğŸ‘ğŸ¿	1
This version Backhand Index Pointing Left emoji Dark Skin Tone applied displayed Black Skin Tone supp	ğŸ‘ˆğŸ¿	1
The flag Cape Verde letters Â  CV Â  platforms The Flag Cape Verde emoji sequence Regional  	ğŸ‡¨ğŸ‡»	1
A newspaper rolled Â  delivery house Rolled Newspaper approved Unicode 7.0 2014 â€œ Rolled Up Ne	ğŸ—	1
A fishcake fish cake Asian meals known Narutomaki Japanese Each slice Â  includes spiral design visual  	ğŸ¥	1
An elderly male face Â  Â  gray Â  grey hair visible wrinkles Balding versions artwork Apple Microsoft m	ğŸ‘´	1
A single human Â  ear May Â  context listening hearing Ear approved Unicode 6.0 2010 added	ğŸ‘‚	1
A person shown sport fencing Rapier style sword mask protective clothing Person Fencing approved Uni	ğŸ¤º	1
The flag Georgia letters Â  GE Â  platforms The Flag Georgia emoji sequence Regional Indica	ğŸ‡¬ğŸ‡ª	1
A red fire truck essential emergency services police car Â  Â  ambulance May way fire Fire En	ğŸš’	1
A camel bump found parts Africa India More common bump Bactrian Camel Camel approved Unico	ğŸª	1
This version Baby emoji Medium dark Skin Tone applied displayed Dark Brown Skin Tone supported platfo	ğŸ‘¶ğŸ¾	1
A Â  raised hand showing reverse palm Â  May paired forward facing raised hand emoji Raised Back Hand approv	ğŸ¤š	1
A paperclip Â  holding multiple pieces paper ejecting SIM cards Â  mobile phones Also known Clippy	ğŸ“	1
A rocket propelled space Rocket approved Unicode 6.0 2010 added Emoji 1.0 2015 Copy paste  	ğŸš€	1
On verge tears emoji tightly closed eyes quivering mouth Confounded Face approved Unicode 6.0 201	ğŸ˜–	1
This version Person Bowing emoji Dark Skin Tone applied displayed Black Skin Tone supported platforms	ğŸ™‡ğŸ¿	1
The flag Cambodia letters Â  KH Â  platforms The Flag Cambodia emoji sequence Regional Indi	ğŸ‡°ğŸ‡­	1
A person riding bicycle leisure sport transport Intended gender neutral Person Biking approved Unicode 6.0  	ğŸš´	1
Pen approved Unicode 7.0 2014 â€œ Lower Left Ballpoint Pen â€ added Emoji 1.0 2015 Copy paste thi	ğŸ–Š	1
An icon representing place leave luggage Most commonly found Japanese train Â  stations signify Â  coin lockers Â  bags stor	ğŸ›…	1
Two arrows Â  forming circle pointing anticlockwise direction Some web browsers use symbol similar refresh function	ğŸ”„	1
A Â  cooked Â  leg turkey chicken form poultry This poultry leg eaten roast Â  dinner bone  	ğŸ—	1
This version Vulcan Salute emoji Light Skin Tone applied displayed Pale Skin Tone supported platforms	ğŸ––ğŸ»	1
This version Person Taking Bath emoji Medium dark Skin Tone applied displayed Dark Brown Skin Tone su	ğŸ›€ğŸ¾	1
The Â  Aries astrological sign Zodiac This Zodiac Symbol represents Ram Aries approved Unicode 1.1 1993 added  	â™ˆ	1
The flag Guinea Bissau letters Â  GW Â  platforms The Flag Guinea Bissau emoji sequence Reg	ğŸ‡¬ğŸ‡¼	1
A magnifying glass pointing right The Left Pointing Magnifying Glass Emoji Â  glass right instead  	ğŸ”	1
An icon Â  represent cyclone Â  Some versions emoji Â  Â  Â  spiral shape decorative purposes Cyclone	ğŸŒ€	1
The Flag Congo Kinshasa emoji sequence Regional Indicator Symbol LetÂ­ter C Regional Indicator Symbol LetÂ­ter D e	ğŸ‡¨ğŸ‡©	1
A water closet public toilet bathroom restroom countries Typically abbreviated letters WC  	ğŸš¾	1
This version Baby Angel emoji Light Skin Tone applied displayed Pale Skin Tone supported platforms C	ğŸ‘¼ğŸ»	1
The flag Albania letters AL platforms The Flag Albania emoji sequence Regional Indica	ğŸ‡¦ğŸ‡±	1
The sun Â  shown cloud 20 visible Very similar sun cloud emoji sun visible See g	ğŸŒ¥	1
A bag money Most likely coins given shape bag Has dollar sign confuse ba	ğŸ’°	1
A seat refer form place Â  sit distinction seat generally fixed Â  chair	ğŸ’º	1
A symbol relation Indian religions Â  Hinduism Buddhism Sikhism Jainism Om approved Unicode 7.0	ğŸ•‰	1
A face distinctively colored face makeup intended entertain children physical comedy May juggle create Â   balloon anima	ğŸ¤¡	1
The flag Slovakia letters Â  SK Â  platforms The Flag Slovakia emoji sequence Regional Indi	ğŸ‡¸ğŸ‡°	1
The Milky Way â€“ galaxy Â  billions stars includes Â  Â  solar system planet earth Represented emoji realistically App	ğŸŒŒ	1
The flag Â  Turkey letters Â  TR Â  platforms The Flag Turkey emoji sequence Regional Indicato	ğŸ‡¹ğŸ‡·	1
A gold medal given person won sporting event race Not confused military medal emoji Sports Medal	ğŸ…	1
A fleshy pink orange colored peach Â  fuzzy skin Displayed green leaf leaves platforms Most commonly butt	ğŸ‘	1
This version Person Running emoji Medium Skin Tone applied displayed Moderate Brown Skin Tone support	ğŸƒğŸ½	1
Multiple paperclips linked All platforms display emoji paperclips LG shows paperclips Not	ğŸ–‡	1
The flag Â  Libya letters Â  LY Â  platforms The Flag Libya emoji sequence Regional Indicator  	ğŸ‡±ğŸ‡¾	1
This version Flexed Biceps emoji Medium Skin Tone applied displayed Moderate Brown Skin Tone supporte	ğŸ’ªğŸ½	1
A roller coaster theme park going dip ride Three carriages seen people red carriage Roller Coas	ğŸ¢	1
A cube shaped building located centre Al Masjid al Haram Mosque Mecca Kaaba approved Unicode 8.0 2015	ğŸ•‹	1
A pot containing variety food Pot Food approved Unicode 6.0 2010 added Emoji 1.0 2015 Copy paste t	ğŸ²	1
A person getting Â  face massaged Apple artwork Â  character shows head massage Google Microsoft display m	ğŸ’†	1
The bus showing windscreen Â  wing mirrors versions emoji Oncoming Bus approved Uni	ğŸš	1
A board contains scene number film A person â€˜ claps â€™ board shut saying â€œ Action â€ â€œ Cut â€ indica	ğŸ¬	1
A face featuring straight closed mouth giving away particular emotion Neutral Face approved Unicode 6.0 20	ğŸ˜	1
A heart emoji arrow center like arrow cupid shoots love Heart With Arrow approved Unicode  	ğŸ’˜	1
A construction worker wearing hard hat safety helmet safety May Â  tired hard day work Some platforms display cross o	ğŸ‘·	1
A gold crown jewels sides Representative King Queen form Royalty Crown approved Unicode 6.0  	ğŸ‘‘	1
This version Ear emoji Light Skin Tone applied displayed Pale Skin Tone supported platforms Copy	ğŸ‘‚ğŸ»	1
A locked closed Â  padlock Â  ink pen known fountain pen Â  May related key signing term digita	ğŸ”	1
The oval shaped ball game rugby Varies slightly shape Â  main versions game rugby union Â  Â  rugby league	ğŸ‰	1
A mouse face drawn cartoon style whiskers rounded ears Mouse Face approved Unicode 6.0 2010 added	ğŸ­	1
A hibiscus emoji pretty flower attract butterflies bees Hibiscus approved Unicode 6.0 2010	ğŸŒº	1
The flag Dominican Republic letters Â  DO Â  platforms The Flag Dominican Republic emoji sequence  	ğŸ‡©ğŸ‡´	1
This version Old Woman emoji Medium dark Skin Tone applied displayed Dark Brown Skin Tone supported p	ğŸ‘µğŸ¾	1
A candle burning red orange yellow flame Some versions emoji display wax dripping candle Candle ap	ğŸ•¯	1
A white flag shown waving post Traditionally sign surrender meaning flag emoji defined White	ğŸ³	1
A pregnant woman intended complete family emoji Â  set Pregnant Woman approved Unicode 9.0 2016 added Emoji 3	ğŸ¤°	1
Sunglasses worn outside protection sun Often association connotations cool leisurely sunny  	ğŸ•¶	1
A retail bank branch people perform money related tasks Also common location find ATM This emoji came mean sla	ğŸ¦	1
This version Guard emoji Medium Skin Tone applied displayed Moderate Brown Skin Tone supported platfo	ğŸ’‚ğŸ½	1
A point shoot Â  camera photos popularity smartphones Similar camera flash emoji Camera appro	ğŸ“·	1
Megaphone approved Unicode 6.0 2010 â€œ Cheering Megaphone â€ added Emoji 1.0 2015 Copy paste thi	ğŸ“£	1
This version Person Rowing Boat emoji Light Skin Tone applied displayed Pale Skin Tone supported plat	ğŸš£ğŸ»	1
A hot beverage Â  cup Generally Â  tea coffee emoji Â  Â  hot drink Hot Beverage approved Uni	â˜•	1
This version Person Swimming emoji Medium light Skin Tone applied displayed Cream White Skin Tone sup	ğŸŠğŸ¼	1
A check mark displays white outlined appearance Shows Â  platforms bright green rounded rectangle circle surroun	âœ…	1
This version Bride With Veil emoji Dark Skin Tone applied displayed Black Skin Tone supported platfor	ğŸ‘°ğŸ¿	1
A Â  wrist watch Â  Â  generally displayed analogue portable timepiece Â  Apple emoji artwork Â  displays Apple Watch instead t	âŒš	1
BACK Arrow approved Unicode 6.0 2010 â€œ Back With Leftwards Arrow Above â€ added Emoji 1.0 2015 Copy	ğŸ”™	1
A fork Â  knife Â  set utensils assist eating meals Displayed fork left knife right  	ğŸ´	1
A pig head distinct pig emoji shows pig body Displayed forward facing distinctive snout Pig Face	ğŸ·	1
Cityscape approved Unicode 7.0 2014 added Emoji 1.0 2015 Copy paste emoji Copy	ğŸ™	1
A speaker cone displayed sound Â  wave generally icon indicate decreasing Â  volume phone computer Previou	ğŸ”‰	1
A gold yellow bell red line Â  commonly mobile phones icon silencing notifications r	ğŸ”•	1
The flag Burkina Faso letters Â  BF Â  platforms The Flag Burkina Faso emoji sequence Regio	ğŸ‡§ğŸ‡«	1
A thermometer way measure temperature May relation weather generally hot illness Thermometer approve	ğŸŒ¡	1
A pot honey Â  honey bee Honey Pot approved Unicode 6.0 2010 added Emoji 1.0 2015 Copy paste th	ğŸ¯	1
Balance scales commonly reference scales held Lady Justice representing weighing evidence Balance Scale	âš–	1
A ruler drawing straight lines Â  measuring length Straight Ruler approved Unicode 6.0 2010 add	ğŸ“	1
The flag Cameroon letters Â  CM Â  platforms The Flag Cameroon emoji sequence Regional Indi	ğŸ‡¨ğŸ‡²	1
This version Backhand Index Pointing Up emoji Dark Skin Tone applied displayed Black Skin Tone suppor	ğŸ‘†ğŸ¿	1
This version Nose emoji Dark Skin Tone applied displayed Black Skin Tone supported platforms Copy	ğŸ‘ƒğŸ¿	1
A mountain snow resting higher altitudes Similar appearance Mount Fuji emoji Snow capped Mountain approved o	ğŸ”	1
This version Folded Hands emoji Light Skin Tone applied displayed Pale Skin Tone supported platforms	ğŸ™ğŸ»	1
A shop generally open longer hours regular supermarket 24 hours day Sells range goods snacks m	ğŸª	1
The Flag Caribbean Netherlands emoji sequence Regional Indicator Symbol LetÂ­ter B Regional Indicator Symbol LetÂ­te	ğŸ‡§ğŸ‡¶	1
A bowl healthy salad containing lettuce tomato salad items cucumber Green Salad approved Unicode 9.0	ğŸ¥—	1
The flag Czech Republic letters Â  CZ Â  platforms The Flag Czech Republic emoji sequence R	ğŸ‡¨ğŸ‡¿	1
Cloud With Lightning Rain approved Unicode 5.2 2009 â€œ Thunder Cloud Rain â€ added Emoji 1.0  	â›ˆ	1
This version Person Pouting emoji Light Skin Tone applied displayed Pale Skin Tone supported platform	ğŸ™ğŸ»	1
A church building love heart symbolising wedding inside building usually bride groom Wedding approved  	ğŸ’’	1
Multiple houses House approved Unicode 7.0 2014 â€œ House Buildings â€ added Emoji 1.0 2015 Copy	ğŸ˜	1
A clipboard quick access pages paper provides hard surface write Clipboard approved Unicode 6.0	ğŸ“‹	1
A red symbol found Anime Manga Â  Â  represent Â  veins popping angry person Also Â  Â  comic books indicate	ğŸ’¢	1
A tiger emoji orange black stripes Â  Created photorealistic style Apple artwork cartoon style Google version One o	ğŸ…	1
This version Person Mountain Biking emoji Dark Skin Tone applied displayed Black Skin Tone supported  	ğŸšµğŸ¿	1
The flag Samoa letters Â  WS Â  platforms The Flag Samoa emoji sequence Regional Indicator  	ğŸ‡¼ğŸ‡¸	1
This version Person Getting Haircut emoji Medium dark Skin Tone applied displayed Dark Brown Skin Tone o	ğŸ’‡ğŸ¾	1
A bottle nail polish colored nail polish applied finger nails Sometimes end sentence display air Â  	ğŸ’…	1
The flag Comoros letters Â  KM Â  platforms Comoran Flag Emoji The Flag Comoros emoji sequence o	ğŸ‡°ğŸ‡²	1
A cheeseburger emoji known burger Â  Two buns containing meat patty cheese lettuce tomato Hamburger	ğŸ”	1
The flag Â  Zimbabwe letters Â  ZW Â  platforms The Flag Zimbabwe emoji sequence Regional Indi	ğŸ‡¿ğŸ‡¼	1
The flag Â  Liechtenstein letters Â  LI Â  platforms The Flag Liechtenstein emoji sequence Reg	ğŸ‡±ğŸ‡®	1
A bell attention reception desk Goes ding tink pressed Bellhop Bell approved Unico	ğŸ›	1
A printed page curled The Apple version emoji contains following words Dear Katie Here crazy ones Th	ğŸ“ƒ	1
A stop icon displayed square Stop Button approved Unicode 7.0 2014 â€œ Black Square Stop â€ added	â¹	1
A decorative Â  exclamation mark heart forms symbol circle lower Similar way man	â£	1
The Flag Bosnia Herzegovina emoji sequence Regional Indicator Symbol LetÂ­ter B Regional Indicator Symbol LetÂ­ter	ğŸ‡§ğŸ‡¦	1
Four Oâ€™clock approved Unicode 6.0 2010 â€œ Clock Face Four O'Clock â€ added Emoji 1.0 2015 Copy p	ğŸ•“	1
A bright red garden strawberry A sweet fruit generally Â  referred simply strawberry Strawberry approved Unicode 6.0	ğŸ“	1
A mobile phone arrow pointing Intended incoming phone Â  Â  indicate Â  de	ğŸ“²	1
A single human eye looking forward This eye different shape style pair eyes rounded looking  	ğŸ‘	1
A baby chicken chick facing forward Front facing Baby Chick approved Unicode 6.0 2010 â€œ Front Facing Bab	ğŸ¥	1
The face princess young Â  girl woman wearing small crown tiara Has yellow Â  hair previously blonde Apple devices b	ğŸ‘¸	1
Twisted arrows pointing right Used indicate Â  putting music â€˜ shuffle â€™ randomizing order Â  tracks Â  upcoming playlist Shuffl	ğŸ”€	1
A Â  sparkler form hand held firework parties celebrations The sparkler lit end Â  held Â   Mo	ğŸ‡	1
A pedestrian symbol red stroke indicating Â  pedestrians prohibited location May seen dedicated bi	ğŸš·	1
The flag Â  Taiwan letters Â  TW Â  platforms The Flag Taiwan emoji sequence Regional Indicato	ğŸ‡¹ğŸ‡¼	1
The flag Guadeloupe letters Â  GP Â  platforms The latest versions iOS OS X use local unofficial fl	ğŸ‡¬ğŸ‡µ	1
Foggy weather emoji Â  Shows Â  fog covering view bridge Apple artwork Google Twitter display high rise city buildings	ğŸŒ	1
The flag Russia letters Â  RU Â  platforms The Flag Russia emoji sequence Regional Indicato	ğŸ‡·ğŸ‡º	1
A chain emoji symbol link web Link approved Unicode 6.0 2010 â€œ Link Symbol â€ add	ğŸ”—	1
This version Person Wearing Turban emoji Light Skin Tone applied displayed Pale Skin Tone supported p	ğŸ‘³ğŸ»	1
The flag Â  South Africa letters Â  ZA Â  platforms The Flag South Africa emoji sequence Regio	ğŸ‡¿ğŸ‡¦	1
The flag Â  Niger letters Â  NE Â  platforms The Flag Niger emoji sequence Regional Indicator  	ğŸ‡³ğŸ‡ª	1
A pretty light pink flower bloom The cherry blossom popular Japan Japanese art Weather Â  forecasts track cherry bloss	ğŸŒ¸	1
Label approved Unicode 7.0 2014 added Emoji 1.0 2015 Copy paste emoji Copy	ğŸ·	1
A view city buildings light disappears sky An orange blue glow lingers stars night sky beco	ğŸŒ†	1
The flag Â  Northern Mariana Islands letters Â  MP Â  platforms The Flag Northern Mariana Islands emoji  	ğŸ‡²ğŸ‡µ	1
The game billiards Â  pool common version This emoji displays black 8 ball platforms looks similar	ğŸ±	1
This version Woman Dancing emoji Dark Skin Tone applied displayed Black Skin Tone supported platforms	ğŸ’ƒğŸ¿	1
Decorative sparkling stars kind Â  indicate item Â  â€˜ sparkling clean â€™ clean Â  shiny Sparkles approved	âœ¨	1
This version Old Woman emoji Light Skin Tone applied displayed Pale Skin Tone supported platforms Co	ğŸ‘µğŸ»	1
A glyph kawaii Japan resembling Â  shape Â  flower Diamond With Dot approved Unicode 6.0 2010 u	ğŸ’ 	1
A teacup handle commonly Japan drink matcha Matcha powdered tea distinctive green color	ğŸµ	1
This version Backhand Index Pointing Up emoji Medium Skin Tone applied displayed Moderate Brown Skin Ton	ğŸ‘†ğŸ½	1
This version Person Walking emoji Light Skin Tone applied displayed Pale Skin Tone supported platform	ğŸš¶ğŸ»	1
A postbox letters mail posted order delivered Postbox approved Unicode 6.0 2010 added  	ğŸ“®	1
This version Raised Hand emoji Medium Skin Tone applied displayed Moderate Brown Skin Tone supported p	âœ‹ğŸ½	1
A seedling sign spring A new plant kind sprouting earth hoping grow large tree flower plant condit	ğŸŒ±	1
This version Girl emoji Light Skin Tone applied displayed Pale Skin Tone supported platforms Copy	ğŸ‘§ğŸ»	1
The flag Greece letters Â  GR Â  platforms The Flag Greece emoji sequence Regional Indicato	ğŸ‡¬ğŸ‡·	1
A ring displaying Â  gem stone kind likely diamond This piece jewellery Â  associated propos	ğŸ’	1
This version OK Hand emoji Medium dark Skin Tone applied displayed Dark Brown Skin Tone supported pla	ğŸ‘ŒğŸ¾	1
A purple heart emoji Shown pink Android 4.4 Purple Heart approved Unicode 6.0 2010 added Emoji 1.0 2015	ğŸ’œ	1
A cute baby chicken Â  hatching egg seeing world time Hatching Chick approved Unicode 6.0 201	ğŸ£	1
An owl shown facing forward large eyes yellow beak Owl approved Unicode 9.0 2016 added Emoji 3.0  	ğŸ¦‰	1
An orange colored basketball displayed hoop Â  Many versions emoji omit Â  hoop Â  display basketball This emoji c	ğŸ€	1
The face lion referred king jungle Displays cute cartoon style face Apple artwork appears	ğŸ¦	1
The flag Chad letters Â  TD Â  platforms The Flag Chad emoji sequence Regional Indicator Sy	ğŸ‡¹ğŸ‡©	1
A consumer video camera record home movies 1980s 1990s Displayed platforms Â  compact design Â  flip screen	ğŸ“¹	1
This version Person Gesturing OK emoji Medium light Skin Tone applied displayed Cream White Skin Tone	ğŸ™†ğŸ¼	1
A hockey stick ball sport field hockey Not confused ice hockey stick puck Field Hockey approved	ğŸ‘	1
This version Raised Fist emoji Medium Skin Tone applied displayed Moderate Brown Skin Tone supported p	âœŠğŸ½	1
Ophiuchus 13th sign Zodiac The symbol ophiuchus appears U shape wavy line Ophiuchus wa	â›	1
The flag Ghana letters Â  GH Â  platforms The Flag Ghana emoji sequence Regional Indicator  	ğŸ‡¬ğŸ‡­	1
The flag Â  Kyrgyzstan letters Â  KG Â  platforms The Flag Kyrgyzstan emoji sequence Regional  	ğŸ‡°ğŸ‡¬	1
A European style post office A Â  postal horn seen commonly found logos European Postal Services Post	ğŸ¤	1
This version Nose emoji Medium dark Skin Tone applied displayed Dark Brown Skin Tone supported platfo	ğŸ‘ƒğŸ¾	1
A paddle ping pong ball sport table tennis Ping Pong approved Unicode 8.0 2015 â€œ Table T	ğŸ“	1
A fist pointing left conjunction right facing fist complete fist bump gesture Left facing Fist appr	ğŸ¤›	1
The flag Burundi letters Â  BI Â  platforms The Flag Burundi emoji sequence Regional Indica	ğŸ‡§ğŸ‡®	1
A handbag predominantly women carry personal items and/or fashion accessory The style emoji varies greatly plat	ğŸ‘œ	1
The flag Romania letters Â  RO Â  platforms The Flag Romania emoji sequence Regional Indica	ğŸ‡·ğŸ‡´	1
A plug power device electrical outlet Shown Â  USA style prong plug numerous countries world Ele	ğŸ”Œ	1
A suburban looking house Â  tree flower shrubs garden House With Garden approved Unicode 6.0 2	ğŸ¡	1
A shower shower head Shower approved Unicode 6.0 2010 added Emoji 1.0 2015 Copy paste emoji Copy	ğŸš¿	1
A small rowboat suitable Â  small number people Â  Couples Â  families hire activity calm waters Person Rowing	ğŸš£	1
A small section music keyboard opposed computer keyboard Showing white black keys keyboard played pianist t	ğŸ¹	1
Orthodox Cross approved Unicode 1.1 1993 added Emoji 1.0 2015 Copy paste emoji Copy	â˜¦	1
A turtle shell Looks similar tortoise Turtle approved Unicode 6.0 2010 added Emoji 1.0 2015 Copy	ğŸ¢	1
An angry looking face Has inward facing eyebrows frowning mouth Expresses anger grumpiness annoyance situation Angry Face	ğŸ˜ 	1
A guitar shown electric guitar Apple Google acoustic guitar Microsoft Twitter Guitar approved  	ğŸ¸	1
The flag Â  South Sudan letters Â  SS Â  platforms The Flag South Sudan emoji sequence Regiona	ğŸ‡¸ğŸ‡¸	1
A symbol relation Indian religions Â  Hinduism Buddhism Sikhism Jainism Wheel Dharma approved  	â˜¸	1
This means lack CJK Ideographs characters Chinese Japanese Korean languages Their writing s	ğŸˆš	1
This version Person Frowning emoji Light Skin Tone applied displayed Pale Skin Tone supported platfor	ğŸ™ğŸ»	1
A flashlight emoji known torch outside North America Used dark â€“ electricity camping  	ğŸ”¦	1
This version Old Woman emoji Dark Skin Tone applied displayed Black Skin Tone supported platforms Co	ğŸ‘µğŸ¿	1
This version Person Gesturing NO emoji Dark Skin Tone applied displayed Black Skin Tone supported pla	ğŸ™…ğŸ¿	1
The symbol baby usually indicate room suitable change baby Often located near public restrooms Baby	ğŸš¼	1
A person lifting Â  barbell loaded weights head Person Lifting Weights approved Unicode 7.0 2014 th	ğŸ‹	1
A small bus designed carry people sized bus Minibus approved Unicode 6.0 2010 added Emoji 1.0	ğŸš	1
A screaming face hands holding jaw cheeks fear Wide eyes shown open mouth The Samsung version emoj	ğŸ˜±	1
A whale emoji spouting water blowhole Shows cartoon like appearance iOS compared regular whale emoji Sp	ğŸ³	1
This Â  character Â  means available Japanese This Â  context Â  parking space vacant hotel room CJK I d	ğŸˆ³	1
This version Person Bowing emoji Light Skin Tone applied displayed Pale Skin Tone supported platforms	ğŸ™‡ğŸ»	1
The moon shown Â  right lit rest shadow First Quarter Moon approved Unicode 6.0 2010 nam	ğŸŒ“	1
A cute cartoon styled rabbit face shown long ears Some platforms display emoji Â  buck Â  teeth Sometimes Easter	ğŸ°	1
This version Ear emoji Medium dark Skin Tone applied displayed Dark Brown Skin Tone supported platfor	ğŸ‘‚ğŸ¾	1
Moon Viewing Ceremonies called Tsukimi Japan held year autumn celebrate moon waxing moon Â  Japan This sym	ğŸ‘	1
The flag Â  Madagascar letters Â  MG Â  platforms The Flag Madagascar emoji sequence Regional I	ğŸ‡²ğŸ‡¬	1
A seashell found beach It spiral shape home hermit crab Spiral Shell approved Unicode 6.0	ğŸš	1
One Â  wise monkeys known Â  Kikazaru This Hear No Evil monkey hands covering ears proverb â€œ evil	ğŸ™‰	1
Badminton approved Unicode 8.0 2015 â€œ Badminton Racquet Shuttlecock â€ added Emoji 1.0 2015 Cop	ğŸ¸	1
This emoji means posses CJK Ideographs characters Chinese Japanese Korean languages Their writing systems c	ğŸˆ¶	1
This version Vulcan Salute emoji Medium light Skin Tone applied displayed Cream White Skin Tone suppo	ğŸ––ğŸ¼	1
Denotes â€œ good bargain â€ Japanese Japanese â€œ bargain â€ Button approved Unicode 6.0 2010 â€œ Circled Ideograp	ğŸ‰	1
This version Person Biking emoji Dark Skin Tone applied displayed Black Skin Tone supported platforms	ğŸš´ğŸ¿	1
A wave ocean open sea Could surf jump waves beach The Apple artwork emoji based f	ğŸŒŠ	1
The flag Â  Turkmenistan letters Â  TM Â  platforms The Flag Turkmenistan emoji sequence Regio	ğŸ‡¹ğŸ‡²	1
The flag Â  Lesotho letters Â  LS Â  platforms The Flag Lesotho emoji sequence Regional Indica	ğŸ‡±ğŸ‡¸	1
The flag Â  Uruguay letters Â  UY Â  platforms The Flag Uruguay emoji sequence Regional Indica	ğŸ‡ºğŸ‡¾	1
A restroom symbol depicting iconography man woman Used indicate location public bathrooms toilets restrooms Used	ğŸš»	1
The flag France letters Â  FR Â  platforms The Flag France emoji sequence Regional Indicato	ğŸ‡«ğŸ‡·	1
A person downhill skiiing Displayed poles skis generally wearing mask Platforms vary display scarf helmet color	â›·	1
This version Horse Racing emoji Medium dark Skin Tone applied displayed Dark Brown Skin Tone supporte	ğŸ‡ğŸ¾	1
Eleven Oâ€™clock approved Unicode 6.0 2010 â€œ Clock Face Eleven O'Clock â€ added Emoji 1.0 2015 Copy	ğŸ•š	1
A Â  wooden painted horse found carousel Â  carnival Faces left screen A previous version Windows displayed carous	ğŸ 	1
The flag Kosovo letters XK platforms The Flag Kosovo emoji sequence Regional Indicato	ğŸ‡½ğŸ‡°	1
A pan food Â  commonly associated Â  paella rice dish Â  originating Â  Valencia Â  Spain Shallow Pan Food approved	ğŸ¥˜	1
The flag Â  Monaco letters Â  MC Â  platforms The Flag Monaco emoji sequence Regional Indicato	ğŸ‡²ğŸ‡¨	1
Yin Yang approved Unicode 1.1 1993 added Emoji 1.0 2015 Copy paste emoji Copy	â˜¯	1
The flag Â  New Caledonia letters Â  NC Â  platforms The Flag New Caledonia emoji sequence Reg	ğŸ‡³ğŸ‡¨	1
The flag Aruba letters AW platforms The Flag Aruba emoji sequence Regional Indicator  	ğŸ‡¦ğŸ‡¼	1
A gambling machine generally found casinos Shows wheels lever Most platforms display 7 digits em	ğŸ°	1
A type pill capsule Shown platforms half red half yellow Notable exceptions include Android blue Windows red bl	ğŸ’Š	1
The flag Â  Diego Garcia letters DG platforms The flag Â  British Indian Ocean Territory The	ğŸ‡©ğŸ‡¬	1
This version Person Gesturing OK emoji Dark Skin Tone applied displayed Black Skin Tone supported pla	ğŸ™†ğŸ¿	1
Raindrops falling cloud People standing probably use umbrella dry Cloud With Rain approved o	ğŸŒ§	1
A crossing sign children usually positioned near schools areas drivers cautious young children area  	ğŸš¸	1
This version Baby Angel emoji Dark Skin Tone applied displayed Black Skin Tone supported platforms C	ğŸ‘¼ğŸ¿	1
Strips cooked bacon popular range dishes accompany eggs Bacon approved Unicode 9.0 2016	ğŸ¥“	1
This version Waving Hand emoji Medium light Skin Tone applied displayed Cream White Skin Tone support	ğŸ‘‹ğŸ¼	1
A sandal worn woman summer spring weather suits open toed footwear Has heel providing additional heig	ğŸ‘¡	1
The flag Â  Sri Lanka letters Â  LK Â  platforms The Flag Sri Lanka emoji sequence Regional In	ğŸ‡±ğŸ‡°	1
The flag Â  Vietnam letters Â  VN Â  platforms The Flag Vietnam emoji sequence Regional Indica	ğŸ‡»ğŸ‡³	1
This version Man With Chinese Cap emoji Medium light Skin Tone applied displayed Cream White Skin Tone o	ğŸ‘²ğŸ¼	1
This version Blond haired Person emoji Medium Skin Tone applied displayed Moderate Brown Skin Tone su	ğŸ‘±ğŸ½	1
This version Police Officer emoji Medium dark Skin Tone applied displayed Dark Brown Skin Tone suppor	ğŸ‘®ğŸ¾	1
Classical Building approved Unicode 7.0 2014 added Emoji 1.0 2015 Copy paste emoji Copy	ğŸ›	1
This version Backhand Index Pointing Left emoji Medium light Skin Tone applied displayed Cream White Ski	ğŸ‘ˆğŸ¼	1
A map planet earth shown platforms Â  physical paper map crease lines folded This emoji sh	ğŸ—º	1
A Moyai spelled Moai type human rock carving Easter Island Moyai Â  statue located near Â  Shibuya Station Tokyo	ğŸ—¿	1
This version Man emoji Medium light Skin Tone applied displayed Cream White Skin Tone supported platf	ğŸ‘¨ğŸ¼	1
This version Person Tipping Hand emoji Medium light Skin Tone applied displayed Cream White Skin Tone	ğŸ’ğŸ¼	1
Cross Mark Button approved Unicode 6.0 2010 â€œ Negative Squared Cross Mark â€ added Emoji 1.0 2015 C	â	1
The flag Â  Palau letters Â  PW Â  platforms The Flag Palau emoji sequence Regional Indicator  	ğŸ‡µğŸ‡¼	1
A symbol showing numbers Â  1 2 3 4 Intended software keyboard input screen enable symbol Â  input opp	ğŸ”¢	1
A calendar feature single date month view calendar Not confused Tear Off Calendar The date displays July	ğŸ“…	1
A right hand holding pen pencil writing Shown blue pen platforms Apple black pen Writing Hand wa	âœ	1
This version Princess emoji Medium light Skin Tone applied displayed Cream White Skin Tone supported  	ğŸ‘¸ğŸ¼	1
A look concern blue forehead sweat dripping cheek The exception emoji Windows version appeare	ğŸ˜°	1
A steam train powered coal wood Â  An early type locomotive replaced electric diesel trains Oddly Â  emoji doe	ğŸš‚	1
The flag Â  Ukraine letters Â  UA Â  platforms The Flag Ukraine emoji sequence Regional Indica	ğŸ‡ºğŸ‡¦	1
This version Bride With Veil emoji Medium light Skin Tone applied displayed Cream White Skin Tone sup	ğŸ‘°ğŸ¼	1
One wise monkeys known Mizaru This See No Evil monkey hands covering eyes proverb â€œ evil	ğŸ™ˆ	1
A palette artist painting store mix paint colors Artist Palette approved Unicode 6.0 2010 add	ğŸ¨	1
A traditional Japanese robe worn women men Kimono approved Unicode 6.0 2010 added Emoji 1.0 2	ğŸ‘˜	1
A classic winky emoji winking smiling Used Â  imply humor written form alternatively suggestively form fl	ğŸ˜‰	1
The cat variant Â  Weary Face Emoji Weary Cat Face approved Unicode 6.0 2010 added Emoji 1.0 2015 Copy	ğŸ™€	1
A national park generally displayed mountains river stream trees National Park approved Unicode 7.0 2014	ğŸ	1
A bicycle called push bike transport sport Bicycle approved Unicode 6.0 2010 added Emoji	ğŸš²	1
A crocodile emoji creature mistaken alligator Crocodile approved Unicode 6.0 2010 added Emoji 1.0  	ğŸŠ	1
A white sheep similar Â  appearance ram Â  emoji May found farm Sheep approved Unicode 6.0 2010	ğŸ‘	1
This version Open Hands emoji Light Skin Tone applied displayed Pale Skin Tone supported platforms C	ğŸ‘ğŸ»	1
A friendly looking cow face looking straight ahead Cow Face approved Unicode 6.0 2010 added Emoji 1.0 2015 Co	ğŸ®	1
Ten pin bowling emoji showing bowling ball pins Bowling approved Unicode 6.0 2010 added Emoji 1.0 2015  	ğŸ³	1
The mark left firm kiss placed bright lipstick Used place â€˜ xxx â€™ kisses send kiss More seductiv	ğŸ’‹	1
The flag Austria letters Â  AT Â  platforms The Flag Austria emoji sequence Regional Indica	ğŸ‡¦ğŸ‡¹	1
Shaved ice syrup added flavor Often referred Â  snow cone Shaved Ice approved Unicode 6.0 2010	ğŸ§	1
Ferry approved Unicode 5.2 2009 added Emoji 1.0 2015 Copy paste emoji Copy	â›´	1
A star points dot center Similar Star David emoji Dotted Six pointed Star approved Unicode	ğŸ”¯	1
The flag Cayman Islands letters Â  KY Â  platforms The Flag Cayman Islands emoji sequence R	ğŸ‡°ğŸ‡¾	1
This version Person Mountain Biking emoji Medium dark Skin Tone applied displayed Dark Brown Skin Tone o	ğŸšµğŸ¾	1
One Oâ€™clock approved Unicode 6.0 2010 â€œ Clock Face One O'Clock â€ added Emoji 1.0 2015 Copy pas	ğŸ•	1
A blue book reads â€œ Vol 3 John Appleseed â€ Â  cover Apple artwork Blue Book approved Unicode 6.0 2010	ğŸ“˜	1
The flag Italy letters Â  IT Â  platforms The Flag Italy emoji sequence Regional Indicator  	ğŸ‡®ğŸ‡¹	1
A Japanese Â  post office featuring Japanese postal mark building showing mark instead building M	ğŸ£	1
A parcel package delivered containing goods online order The Apple version emoji wine glass symbol	ğŸ“¦	1
A face big smiling mouth scrunched closed eyes May similar context text based Â  emoticon Smiling Face Wit	ğŸ˜†	1
A necktie commonly worn Â  work formal occasions Sometimes displayed Â  shirt tie Colors patterns vary platform Necktie w	ğŸ‘”	1
As Â  mythological creature dragon generally displayed Â  Chinese Japanese traditions One animals Â  Chin	ğŸ‰	1
The flag Greenland letters Â  GL Â  platforms The Flag Greenland emoji sequence Regional In	ğŸ‡¬ğŸ‡±	1
A video cassette tape commonly referred Â  video video tape Used play videos purchased Â  VHS cassette recording telev	ğŸ“¼	1
This version Person Walking emoji Dark Skin Tone applied displayed Black Skin Tone supported platform	ğŸš¶ğŸ¿	1
A gold yellow bell Â  commonly mobile phones icon notifications ringing sounds Bell approved  	ğŸ””	1
A family Â  mothers son The Family Woman Woman Boy emoji sequence Woman Woman Boy emojis These	ğŸ‘©â€ğŸ‘©â€ğŸ‘¦	1
This version Person Wearing Turban emoji Medium dark Skin Tone applied displayed Dark Brown Skin Tone	ğŸ‘³ğŸ¾	1
A construction helmet worn construction worker emoji emoji sets The cross helmet shown Apple Â  versio	â›‘	1
The world showing Asia Australia Globe Showing Asia Australia approved Unicode 6.0 2010 â€œ Earth Globe  	ğŸŒ	1
The flag Â  United Kingdom Great Britain letters GB Â  platforms The emoji flag list based ISO 31	ğŸ‡¬ğŸ‡§	1
The face dog showing eyes ears nose mouth Â  Shows face Â  dog smiling eyes open tongue hanging Goo	ğŸ¶	1
A badge identify oneself location know school trip work conference This Â  t	ğŸ“›	1
The flag Â  Lithuania letters Â  LT Â  platforms The Flag Lithuania emoji sequence Regional In	ğŸ‡±ğŸ‡¹	1
The flag Â  New Zealand letters Â  NZ Â  platforms The Flag New Zealand emoji sequence Regiona	ğŸ‡³ğŸ‡¿	1
This version Raised Hand emoji Dark Skin Tone applied displayed Black Skin Tone supported platforms C	âœ‹ğŸ¿	1
Shield approved Unicode 7.0 2014 added Emoji 1.0 2015 Copy paste emoji Copy	ğŸ›¡	1
A hideous creature crooked teeth horns lots hair Called Namahage Japanapese folklore character depicted	ğŸ‘¹	1
A man dancing intended Â  male equivalent female dancer Man Dancing approved Unicode 9.0 2016 added	ğŸ•º	1
A newspaper people read news previous day prior widespread internet access Shown forms placeholder te	ğŸ“°	1
A version Â  grinning face Â  showing smiling eyes This emoji Â  previously looked closer Â  grimacing face Â  platforms	ğŸ˜	1
A fuel pump fill vehicle gas petrol Shown letter Â  G Apple artwork Fuel Pump approved	â›½	1
The Â  Gemini astrological sign Zodiac This Zodiac Symbol represents Twins Gemini approved Unicode 1.1 1993 adde	â™Š	1
A water fountain found Â  park public space Used decorative purposes A variety styles fountain shown diff	â›²	1
A piece paper printed contents facing Page Facing Up approved Unicode 6.0 2010 added Emoji 1.0  	ğŸ“„	1
The flag Â  Vanuatu letters Â  VU Â  platforms The Flag Vanuatu emoji sequence Regional Indica	ğŸ‡»ğŸ‡º	1
The flag Â  Iraq letters Â  IQ Â  platforms The Flag Iraq emoji sequence Regional Indicator Sy	ğŸ‡®ğŸ‡¶	1
The flag Equatorial Guinea letters Â  GQ Â  platforms The Flag Equatorial Guinea emoji sequence th	ğŸ‡¬ğŸ‡¶	1
The flag Indonesia letters Â  ID Â  platforms The Flag Indonesia emoji sequence Regional In	ğŸ‡®ğŸ‡©	1
The flag Antarctica letters AQ platforms The Flag Antarctica emoji sequence Regional  	ğŸ‡¦ğŸ‡¶	1
This version Guard emoji Medium dark Skin Tone applied displayed Dark Brown Skin Tone supported platf	ğŸ’‚ğŸ¾	1
This version Construction Worker emoji Dark Skin Tone applied displayed Black Skin Tone supported pla	ğŸ‘·ğŸ¿	1
The flag Â  Niue letters Â  NU Â  platforms The Flag Niue emoji sequence Regional Indicator Sy	ğŸ‡³ğŸ‡º	1
A light green colored fruit defines Â  pear shape Pear approved Unicode 6.0 2010 added Emoji 1.0 2015 Co	ğŸ	1
A wedge cheese Not necessarily specific type style cheese likely shown bright yellow appearance Cheese Wedge  	ğŸ§€	1
A mythical creature generally depicted white horse Â  long horn Unicorn Face approved Unicode 8.0 2015 adde	ğŸ¦„	1
The flag Ascension Island letters AC platforms This Â  flag Â  St. Helena Â  Â  Tristan Da Cunh	ğŸ‡¦ğŸ‡¨	1
This version Police Officer emoji Medium light Skin Tone applied displayed Cream White Skin Tone supp	ğŸ‘®ğŸ¼	1
A Â  thumbs gesture indicating approval Thumbs Up approved Unicode 6.0 2010 â€œ Thumbs Up Sign â€ added  	ğŸ‘	1
The flag Â  Pakistan letters Â  PK Â  platforms The Flag Pakistan emoji sequence Regional Indi	ğŸ‡µğŸ‡°	1
An upset person frowning dismay Should gender neutral Â  displays woman iOS man Windows Person Frowning	ğŸ™	1
This version Nail Polish emoji Medium Skin Tone applied displayed Moderate Brown Skin Tone supported  	ğŸ’…ğŸ½	1
The flag Â  Laos letters Â  LA Â  platforms The Flag Laos emoji sequence Regional Indicator Sy	ğŸ‡±ğŸ‡¦	1
Fog haze lingering air Very similar foggy emoji generally shown objects views obstructed fog Sho	ğŸŒ«	1
A light bulb light room Can Â  indicate idea placed face Light Bulb approved Unicode  	ğŸ’¡	1
A person dancing Â  commonly displayed salsa dancing woman wearing red dress .. Originally intended gender neutral c	ğŸ’ƒ	1
Two Japanese Flags crossed base Except Samsung devices display South Korean flags Crossed Flags approved	ğŸŒ	1
The flag Slovenia letters Â  SI Â  platforms The Flag Slovenia emoji sequence Regional Indi	ğŸ‡¸ğŸ‡®	1
A metal device dropped boat prevent drifting away current location An anchor refers place webpage t	âš“	1
The flag French Guiana letters Â  GF Â  platforms The Flag French Guiana emoji sequence Reg	ğŸ‡¬ğŸ‡«	1
The Â  Virgo astrological sign Zodiac This Zodiac Symbol represents Maiden Virgo approved Unicode 1.1 1993 add	â™	1
Means â€œ Here â€ Japanese referring destination Japanese â€œ â€ Button approved Unicode 6.0 2010 â€œ Squ	ğŸˆ	1
A series Zs making Zzz Represents sleeping snoring Can contexts mean â€œ boring â€ Zzz approved  	ğŸ’¤	1
This version Man emoji Dark Skin Tone applied displayed Black Skin Tone supported platforms Copy	ğŸ‘¨ğŸ¿	1
A wide road shown person perspective Apple artwork displays road sign Curpertino Motorway approved Unic	ğŸ›£	1
A curled loop shown black platforms Â  Displayed blue ribbon Samsung devices Similar Double Curly Loop bu	â°	1
A trident pronged spear appears similar pitchfork Often held Greek Roman Gods statues Trident Emblem ap	ğŸ”±	1
A mobile phone red stroke indicating mobile phones present Often seen restricted areas Cu	ğŸ“µ	1
A Â  triangle shaped ruler Used drawing diagonal lines measurement Triangular Ruler approved Unicode 6.0 2010	ğŸ“	1
A yellow green shield symbol called Â  Shoshinsha Mark Must displayed drivers Japan year receive driv	ğŸ”°	1
This version Police Officer emoji Light Skin Tone applied displayed Pale Skin Tone supported platform	ğŸ‘®ğŸ»	1
This version Police Officer emoji Dark Skin Tone applied displayed Black Skin Tone supported platform	ğŸ‘®ğŸ¿	1
Symbol sale bargain prices Japan â€œ cut prices â€ Â  Literally translated character means Â  cut divide CJK Ideographs ar	ğŸˆ¹	1
This version Person Walking emoji Medium dark Skin Tone applied displayed Dark Brown Skin Tone suppor	ğŸš¶ğŸ¾	1
The Â  Capricorn astrological sign Zodiac This Zodiac Symbol represents Goat Capricorn approved Unicode 1.1 1993	â™‘	1
The flag Â  Togo letters Â  TG Â  platforms The Flag Togo emoji sequence Regional Indicator Sy	ğŸ‡¹ğŸ‡¬	1
A circular â€˜ big â€™ circus tent triangle flag Circus Tent approved Unicode 6.0 2010 added Emoji 1	ğŸª	1
Part displeased unsure think This face Â  sad bit confused puzzled situation On spectrum disp	ğŸ˜•	1
A set dividers index cards folders Card Index Dividers approved Unicode 7.0 2014 added Emoji 1.0 2015	ğŸ—‚	1
A sausage bread roll consumed sporting events baseball served ketchup and/or mustard Hot Dog approved  	ğŸŒ­	1
A taco Mexican Â  food item displayed Â  variety fillings Similar burrito Taco approved Unicode 8.0 2015	ğŸŒ®	1
The flag El Salvador letters Â  SV Â  platforms The Flag El Salvador emoji sequence Regiona	ğŸ‡¸ğŸ‡»	1
This version Police Officer emoji Medium Skin Tone applied displayed Moderate Brown Skin Tone support	ğŸ‘®ğŸ½	1
The flag Â  Tunisia letters Â  TN Â  platforms The Flag Tunisia emoji sequence Regional Indica	ğŸ‡¹ğŸ‡³	1
This version Man emoji Medium dark Skin Tone applied displayed Dark Brown Skin Tone supported platfor	ğŸ‘¨ğŸ¾	1
This version Person Getting Massage emoji Light Skin Tone applied displayed Pale Skin Tone supported  	ğŸ’†ğŸ»	1
The letters ID square ID Button approved Unicode 6.0 2010 â€œ Squared ID â€ added Emoji 1.0 2015	ğŸ†”	1
This version Horse Racing emoji Medium Skin Tone applied displayed Moderate Brown Skin Tone supported	ğŸ‡ğŸ½	1
Two human footsteps Â  showing outline feet including toes Footprints approved Unicode 6.0 2010  	ğŸ‘£	1
A spiky looking fish Â  Â  eaten delicacy Japan known fugu Displayed photorealistic style iOS carto	ğŸ¡	1
A Â  popular sweet Japanese dessert stick Â  Similar appearance Â  oden emoji Dango approved Unicode 6.0 2010	ğŸ¡	1
The flag Â  Iran letters Â  IR Â  platforms The Flag Iran emoji sequence Regional Indicator Sy	ğŸ‡®ğŸ‡·	1
A glass wine Â  generally shown Â  red wine inside Wine Glass approved Unicode 6.0 2010 added Emoji 1	ğŸ·	1
An open mailbox flag resting The lowered flag Â  mailbox USA indicate Â  mail del	ğŸ“­	1
A hot pepper known chili pepper originating Mexico Sometimes restaurant menus scale indicate Â  spicy  	ğŸŒ¶	1
This version Blond haired Person emoji Medium light Skin Tone applied displayed Cream White Skin Tone	ğŸ‘±ğŸ¼	1
Two men standing smiling pink love heart floating air The Couple With Heart Man Man emoj	ğŸ‘¨â€â¤ï¸â€ğŸ‘¨	1
This version Person Tipping Hand emoji Medium Skin Tone applied displayed Moderate Brown Skin Tone su	ğŸ’ğŸ½	1
A yellow spiky pineapple green leaves Pineapple approved Unicode 6.0 2010 added Emoji 1.0 2015 Co	ğŸ	1
Skis ski boots worn skiing Â  ski resort Only Microsoft Twitter versions emoji ski boot Appl	ğŸ¿	1
A laughing emoji Â  Â  small sizes mistaken tears sadness Â  This emoji laughing crying tears o	ğŸ˜‚	1
The flag Sierra Leone letters Â  SL Â  platforms The Flag Sierra Leone emoji sequence Regio	ğŸ‡¸ğŸ‡±	1
This version Person Running emoji Medium light Skin Tone applied displayed Cream White Skin Tone supp	ğŸƒğŸ¼	1
A bird Â  Â  species specified Â  Appears like sparrow Android blue previously yellow Windows blue Twitter red Only shows	ğŸ¦	1
Airplane Arrival approved Unicode 7.0 2014 â€œ Airplane Arriving â€ added Emoji 1.0 2015 Copy pas	ğŸ›¬	1
Two pink love hearts One larger Can display â€œ love air â€ On Snapchat emoji contact	ğŸ’•	1
A nut Â  shown Â  bolt Â  screw usually steel shown silver gray color platforms The angle nut bol	ğŸ”©	1
Generic profile people Often interface design represent users Busts Silhouette approved Unicode 6.0	ğŸ‘¥	1
This version Flexed Biceps emoji Medium light Skin Tone applied displayed Cream White Skin Tone suppo	ğŸ’ªğŸ¼	1
A person running large stride Â  arms outstretched Â  May Â  wearing running shirt This emoji specify gender s	ğŸƒ	1
A symbol showing lowercase letters b c d. Intended software keyboard input screen enable alphabetic	ğŸ”¤	1
This version Boy emoji Medium light Skin Tone applied displayed Cream White Skin Tone supported platf	ğŸ‘¦ğŸ¼	1
A Â  pin round plastic end Most commonly mapping software indicate specific location Round Pushpin approved o	ğŸ“	1
The cat variant Â  Grinning Face Emoji Grinning Cat Face With Smiling Eyes approved Unicode 6.0 2010 added Emo	ğŸ˜¸	1
The flag Â  Mali letters Â  ML Â  platforms The Flag Mali emoji sequence Regional Indicator Sy	ğŸ‡²ğŸ‡±	1
The flag Â  Thailand letters Â  TH Â  platforms The Flag Thailand emoji sequence Regional Indi	ğŸ‡¹ğŸ‡­	1
The flag Â  Uganda letters Â  UG Â  platforms The Flag Uganda emoji sequence Regional Indicato	ğŸ‡ºğŸ‡¬	1
A single skate sport recreational activity ice skating Shown facing left platforms Ice Skate approved  	â›¸	1
Two hands raised air celebrating success joyous event Raising Hands approved Unicode 6.0 2010 th	ğŸ™Œ	1
This version Princess emoji Light Skin Tone applied displayed Pale Skin Tone supported platforms Cop	ğŸ‘¸ğŸ»	1
Timer Clock approved Unicode 6.0 2010 added Emoji 1.0 2015 Copy paste emoji Copy	â²	1
Level Slider approved Unicode 7.0 2014 added Emoji 1.0 2015 Copy paste emoji Copy	ğŸš	1
A white rabbit associated Spring Easter One animals Â  Chinese Zodiac Rabbit approved	ğŸ‡	1
A locked closed Â  padlock Â  key shown In Apple artwork text key reads UM242 actual type ke	ğŸ”	1
Person Playing Handball approved Unicode 9.0 2016 â€œ Handball â€ added Emoji 3.0 2016 Copy paste	ğŸ¤¾	1
A tall boot worn Â  women featuring zip slight heel Woman Boot approved Unicode 6.0 2010  	ğŸ‘¢	1
Crescent Moon approved Unicode 6.0 2010 added Emoji 1.0 2015 Copy paste emoji Copy	ğŸŒ™	1
A pig snout nose Pig Nose approved Unicode 6.0 2010 added Emoji 1.0 2015 Copy paste emoji Copy	ğŸ½	1
An umbrella planted ground shade protection beach park Umbrella Ground approved Unicode 5.2  	â›±	1
A symbol exchanging currencies Most commonly displayed dollar symbol arrows yen symbol Some platforms Â  	ğŸ’±	1
A family Â  father mother Â  daughter The Family Man Woman Girl emoji sequence Man Woman Girl emoji	ğŸ‘¨â€ğŸ‘©â€ğŸ‘§	1
The flag Armenia letters AM platforms The Flag Armenia emoji sequence Regional Indica	ğŸ‡¦ğŸ‡²	1
The word arrow pointing TOP Arrow approved Unicode 6.0 2010 â€œ Top With Upwards Ar	ğŸ”	1
A family father mother daughters The Family Man Woman Girl Girl emoji sequence Man Woman Girl	ğŸ‘¨â€ğŸ‘©â€ğŸ‘§â€ğŸ‘§	1
A point star pale yellow color small bursts light shining Generally visual flair astronomic	ğŸŒŸ	1
A face hearts instead eyes Heart Eyes Emoji generally known Â  Used expression love example Â   â€œ I love â€  	ğŸ˜	1
A frying pan egg fried representing cooking Cooking approved Unicode 6.0 2010 added Emoji 1.0 20	ğŸ³	1
This version Construction Worker emoji Medium light Skin Tone applied displayed Cream White Skin Tone	ğŸ‘·ğŸ¼	1
Similar train running single track Â  Monorails found theme parks tourist destinations Monorail app	ğŸš	1
The flag Â  Morocco letters Â  MA Â  platforms The Flag Morocco emoji sequence Regional Indica	ğŸ‡²ğŸ‡¦	1
Two hands performing handshake gesture indicating Â  cordial greeting friends associates Handshake approved Uni	ğŸ¤	1
A type cracker rice known senbei Japan Shown nori seaweed base Â  served Rice Cracke	ğŸ˜	1
A customs officer inspecting luggage May shown signage airports border crossings Not confused passport co	ğŸ›ƒ	1
The flag Christmas Island letters Â  CX Â  platforms The Flag Christmas Island emoji sequence  	ğŸ‡¨ğŸ‡½	1
This version OK Hand emoji Medium Skin Tone applied displayed Moderate Brown Skin Tone supported plat	ğŸ‘ŒğŸ½	1
This version Person Tipping Hand emoji Medium dark Skin Tone applied displayed Dark Brown Skin Tone s	ğŸ’ğŸ¾	1
ATM Sign approved Unicode 6.0 2010 â€œ Automated Teller Machine â€ added Emoji 1.0 2015 Copy past	ğŸ§	1
The Statue Liberty depiction Â  New York City Statue Liberty approved Unicode 6.0 2010 added t	ğŸ—½	1
This version Raised Hand emoji Medium light Skin Tone applied displayed Cream White Skin Tone supporte	âœ‹ğŸ¼	1
A family Â  Â  mothers Â  daughter son The Family Woman Woman Girl Boy emoji sequence Woman Woman  	ğŸ‘©â€ğŸ‘©â€ğŸ‘§â€ğŸ‘¦	1
A piece watermelon showing red pink flesh seeds green rind outside Watermelon approved Unicode 6.0 2	ğŸ‰	1
The flag Â  Zambia letters Â  ZM Â  platforms The Flag Zambia emoji sequence Regional Indicato	ğŸ‡¿ğŸ‡²	1
This version Person Gesturing NO emoji Light Skin Tone applied displayed Pale Skin Tone supported pla	ğŸ™…ğŸ»	1
This version Raising Hands emoji Medium light Skin Tone applied displayed Cream White Skin Tone suppo	ğŸ™ŒğŸ¼	1
This version Waving Hand emoji Light Skin Tone applied displayed Pale Skin Tone supported platforms  	ğŸ‘‹ğŸ»	1
The moon shown Â  lit small portion left Â  shadow Waxing Gibbous Moon approved Unicode 6.0 2010  	ğŸŒ”	1
A domestic pig ancestor wild boar This farm animal created photorealistic style Apple artwork cartoon	ğŸ–	1
A leaf clover common variety leaved clover Considered lucky Not confused shamrock aka th	ğŸ€	1
The flag Honduras letters Â  HN Â  platforms The Flag Honduras emoji sequence Regional Indi	ğŸ‡­ğŸ‡³	1
A large Â  elephant found parts Africa Asia Displayed platforms cartoon style image standing Elephant appro	ğŸ˜	1
This version Clapping Hands emoji Light Skin Tone applied displayed Pale Skin Tone supported platform	ğŸ‘ğŸ»	1
A sign indicating location bus stop Bus Stop approved Unicode 6.0 2010 added Emoji 1.0 2015 Copy  	ğŸš	1
A dolphin emoji leaping air Considered intelligent animals Earth Dolphin approved Unicode  	ğŸ¬	1
A type bus uses overhead electrical wires power Appears similar cross bus tram car Trolleybus approve	ğŸš	1
This version Person Getting Haircut emoji Light Skin Tone applied displayed Pale Skin Tone supported  	ğŸ’‡ğŸ»	1
A Â  star displaying path light indicating movement sky Shooting Star approved Unicode 6.0 2010  	ğŸŒ 	1
A camera usually mobile Â  phone camera held photo person holding May represented outstretched hand ph	ğŸ¤³	1
Two people displayed kissing gesturing kiss Generally displayed woman man At small sizes diff	ğŸ’	1
This character translates meaning finger toe pointing indicate certain direction CJK Ideographs characters Chinese	ğŸˆ¯	1
This version Baby emoji Medium light Skin Tone applied displayed Cream White Skin Tone supported plat	ğŸ‘¶ğŸ¼	1
A frog emoji showing green face Â  frog large eyes mouth Sometimes conjunction Â  hot beverage symbo	ğŸ¸	1
The face Â  Smiling Face With Open Mouth And Smiling Eyes single drop sweat face A rarely emoji	ğŸ˜…	1
The flag Guyana letters Â  GY Â  platforms The Flag Guyana emoji sequence Regional Indicato	ğŸ‡¬ğŸ‡¾	1
A face looks surprised hushed high eyebrows open mouth The appearance similar Â  Astonished face	ğŸ˜¯	1
This version Raised Fist emoji Medium dark Skin Tone applied displayed Dark Brown Skin Tone supported  	âœŠğŸ¾	1
Circular arrows pointing clockwise direction Used music player applications Â  loop track album continuously Repeat Button wa	ğŸ”	1
Crossed Swords approved Unicode 4.1 2005 added Emoji 1.0 2015 Copy paste emoji Copy	âš”	1
A galloping horse saddle The Horse Racing Emoji jockey riding Â  Created photorealistic style Appl	ğŸ	1
The flag Eritrea letters Â  ER Â  platforms The Flag Eritrea emoji sequence Regional Indica	ğŸ‡ªğŸ‡·	1
A Â  face little bit sad Â  slight frown neutral Â  eyes Slightly Frowning Face approved Unicode 7.0 2014	ğŸ™	1
A red apple fruit variety Â  Looks orange Android Red Apple approved Unicode 6.0 2010 added Emoji 1.0  	ğŸ	1
An hourglass Â  sand flowing representing passage Â  time Hourglass With Flowing Sand approved Unicode 6.0 2010	â³	1
The flag Â  Venezuela letters Â  VE Â  platforms The Flag Venezuela emoji sequence Regional In	ğŸ‡»ğŸ‡ª	1
A silver spoon soft liquid foods soup dessert Often paired fork knife Spoon approve	ğŸ¥„	1
A volleyball emoji showing round ball sport Played Summer Olympic Games Volleyball approved	ğŸ	1
A fishing Â  rod pole fish caught end Fishing Pole approved Unicode 6.0 2010 â€œ Fishing Pole	ğŸ£	1
The number eighteen red stroke indicating location person aged 18 enter The Samsung versio	ğŸ”	1
A poodle breed dog commonly seen groomed Â  longer hair head paws tail rest body Poodle appr	ğŸ©	1
This version Santa Claus emoji Medium dark Skin Tone applied displayed Dark Brown Skin Tone supported	ğŸ…ğŸ¾	1
Last Quarter Moon approved Unicode 6.0 2010 â€œ Last Quarter Moon Symbol â€ added Emoji 1.0 2015 Copy	ğŸŒ—	1
A distraught looking emoji open mouth crescent shaped eyes Appears given Very similar appearance Tired F	ğŸ˜©	1
This version Backhand Index Pointing Down emoji Medium Skin Tone applied displayed Moderate Brown Skin T	ğŸ‘‡ğŸ½	1
The flag Â  Montserrat letters Â  MS Â  platforms The Flag Montserrat emoji sequence Regional  	ğŸ‡²ğŸ‡¸	1
This version Old Man emoji Medium light Skin Tone applied displayed Cream White Skin Tone supported p	ğŸ‘´ğŸ¼	1
A scorpion shown legs upright rail May relation zodiac sign Scorpius Scorpion approved par	ğŸ¦‚	1
Admission Tickets approved Unicode 7.0 2014 added Emoji 1.0 2015 Copy paste emoji Copy	ğŸŸ	1
The flag Â  Mexico letters Â  MX Â  platforms The Flag Mexico emoji sequence Regional Indicato	ğŸ‡²ğŸ‡½	1
A symbol showing person putting Â  litter rubbish trash rubbish bin A positive version Do Not Litter Symbol Litter	ğŸš®	1
A train railway Â  mountains Displayed Â  funicular Microsoft artwork Â  Â  regular train platforms Android displa	ğŸš	1
This version Person Swimming emoji Medium dark Skin Tone applied displayed Dark Brown Skin Tone suppo	ğŸŠğŸ¾	1
The flag Â  Marshall Islands letters Â  MH Â  platforms The Flag Marshall Islands emoji sequence  	ğŸ‡²ğŸ‡­	1
This version Person Gesturing OK emoji Light Skin Tone applied displayed Pale Skin Tone supported pla	ğŸ™†ğŸ»	1
This Emoji means â€œ prohibit restrict forbid â€ Japanese CJK Ideographs characters Chinese Japanese Korean languages T	ğŸˆ²	1
Two glasses flutes champagne clinked celebration Similar clinking beer mugs emoji For bottle sparkling  	ğŸ¥‚	1
A Euro Banknote countries Â  European Union Commonly shown Hundred Euro â‚¬ 100 note simplified Â  display Eu	ğŸ’¶	1
A moon face hiding shadow Sometimes perceived creepy regular new moon face New Moon Face app	ğŸŒš	1
A Â  form public transport rails usually found streets cities urban areas For short medium length journeys Trams Â 	ğŸš‹	1
This version Clapping Hands emoji Medium Skin Tone applied displayed Moderate Brown Skin Tone support	ğŸ‘ğŸ½	1
This version Person Taking Bath emoji Medium light Skin Tone applied displayed Cream White Skin Tone  	ğŸ›€ğŸ¼	1
The flag Cyprus letters Â  CY Â  platforms The Flag Cyprus emoji sequence Regional Indicato	ğŸ‡¨ğŸ‡¾	1
A joystick Â  generally displayed red ball stick The number buttons device varies platform Ma	ğŸ•¹	1
This version Person Surfing emoji Medium light Skin Tone applied displayed Cream White Skin Tone supp	ğŸ„ğŸ¼	1
A man wearing suit hovering ground shadow displayed beneath Generally shown wearing fedora similar style ha	ğŸ•´	1
A cigarette Â  smoke showing end Intended smoking symbol sign displays lit cigarette platforms C	ğŸš¬	1
This version Open Hands emoji Dark Skin Tone applied displayed Black Skin Tone supported platforms C	ğŸ‘ğŸ¿	1
A rat emoji Â  confused mouse Â  emoji One animals Chinese Zodiac Rat approved Unicode 6	ğŸ€	1
The flag Â  Tuvalu letters Â  TV Â  platforms The Flag Tuvalu emoji sequence Regional Indicato	ğŸ‡¹ğŸ‡»	1
A turkey bird Â  cooked eaten Thanksgiving Christmas This emoji displays live turkey similar presentat	ğŸ¦ƒ	1
This version Person Pouting emoji Dark Skin Tone applied displayed Black Skin Tone supported platform	ğŸ™ğŸ¿	1
This version Backhand Index Pointing Right emoji Medium dark Skin Tone applied displayed Dark Brown Skin	ğŸ‘‰ğŸ¾	1
A microphone audio recording Â  associated radio broadcasting podcasts Studio Microphone approved U	ğŸ™	1
The flag Â  Clipperton Island letters CP platforms Uses flag France The Flag Clipperton Is	ğŸ‡¨ğŸ‡µ	1
The Â  word Â  cool shown enclosed Â  square This generally displays shade blue blue gray platforms Used text decora	ğŸ†’	1
The flag Â  Nauru letters Â  NR Â  platforms The Flag Nauru emoji sequence Regional Indicator  	ğŸ‡³ğŸ‡·	1
This version Waving Hand emoji Medium Skin Tone applied displayed Moderate Brown Skin Tone supported  	ğŸ‘‹ğŸ½	1
This version Santa Claus emoji Medium Skin Tone applied displayed Moderate Brown Skin Tone supported  	ğŸ…ğŸ½	1
The Â  Leo astrological sign Zodiac This Zodiac Symbol represents Lion Leo approved Unicode 1.1 1993 added  	â™Œ	1
The flag Â  Oman letters Â  OM Â  platforms The Flag Oman emoji sequence Regional Indicator Sy	ğŸ‡´ğŸ‡²	1
The flag Bahamas letters Â  BS Â  platforms The Flag Bahamas emoji sequence Regional Indica	ğŸ‡§ğŸ‡¸	1
This version Waving Hand emoji Dark Skin Tone applied displayed Black Skin Tone supported platforms  	ğŸ‘‹ğŸ¿	1
The flag Â  North Korea letters Â  KP Â  platforms The Flag North Korea emoji sequence Regiona	ğŸ‡°ğŸ‡µ	1
The face boy smiling Differentiated man emoji Android Â  wearing cap iOS lack Â  facial hair Â  It  	ğŸ‘¦	1
A ceramic vase like object Can relation zodiac symbol Aquarius Amphora approved Unicode 8.0 2015  	ğŸº	1
Radioactive approved Unicode 1.1 1993 â€œ Radioactive Sign â€ added Emoji 1.0 2015 Copy paste thi	â˜¢	1
This version Oncoming Fist emoji Medium Skin Tone applied displayed Moderate Brown Skin Tone supporte	ğŸ‘ŠğŸ½	1
Keyboard approved Unicode 1.1 1993 added Emoji 1.0 2015 Copy paste emoji Copy	âŒ¨	1
A Â  police Â  car shown Â  emergency light Â  This emoji displayed opposed Â  police car Â  emoji	ğŸš”	1
This version Vulcan Salute emoji Medium dark Skin Tone applied displayed Dark Brown Skin Tone support	ğŸ––ğŸ¾	1
A face pursed lips slightly blushing making kissing motion More intimate regular Â  kissing face emoji eyes b	ğŸ˜š	1
The flag Â  Martinique letters Â  MQ Â  platforms The latest versions iOS OS X use Â  historical Â  snake fl	ğŸ‡²ğŸ‡¶	1
A pouting face outwardly showing Â  displeasure person situation Displayed furrowed brow platforms emoji com	ğŸ˜¡	1
This version Bride With Veil emoji Medium dark Skin Tone applied displayed Dark Brown Skin Tone suppo	ğŸ‘°ğŸ¾	1
Beads sweat Â  splashing single direction Is distinguishable splashing water Â  water instead sweat So	ğŸ’¦	1
Two curly loops Â  represent Â  reel reel tape recorder Used symbol Â  voicemail phones A variation logo	â¿	1
A female face adult age Differentiated Â  girl Â  emoji Â  lack pig tails hair Woman approved Unicode  	ğŸ‘©	1
This version Clapping Hands emoji Medium light Skin Tone applied displayed Cream White Skin Tone supp	ğŸ‘ğŸ¼	1
A single balloon birthdays celebrations Displayed red platforms Samsung Â  displays Â  blue ballo	ğŸˆ	1
Two hands clapping emoji multiple times Â  round applause Clapping Hands approved Unicode  	ğŸ‘	1
This version Backhand Index Pointing Down emoji Dark Skin Tone applied displayed Black Skin Tone supp	ğŸ‘‡ğŸ¿	1
A hand shown pressing head person commonly written Â  facepalm Used display Â  frustration embarrassment inepti	ğŸ¤¦	1
A blossoming flower Similar Â  Â  cherry blossom necessarily shade Blossom popular TV Show	ğŸŒ¼	1
The Â  Scorpius astrological sign Zodiac This Zodiac Symbol represents Scorpion Scorpius approved Unicode 1.1 1993	â™	1
Potable Water approved Unicode 6.0 2010 â€œ Potable Water Symbol â€ added Emoji 1.0 2015 Copy pas	ğŸš°	1
Saxophone approved Unicode 6.0 2010 added Emoji 1.0 2015 Copy paste emoji Copy	ğŸ·	1
This version Person Frowning emoji Medium Skin Tone applied displayed Moderate Brown Skin Tone suppor	ğŸ™ğŸ½	1
The Â  Libra astrological sign Zodiac This Zodiac Symbol represents weighing scales Libra approved Unicode 1.1 1993  	â™	1
This version Horse Racing emoji Light Skin Tone applied displayed Pale Skin Tone supported platforms	ğŸ‡ğŸ»	1
This version Raising Hands emoji Medium Skin Tone applied displayed Moderate Brown Skin Tone supporte	ğŸ™ŒğŸ½	1
Index finger touching thumb open circle Represents â€œ I okay â€ â€œ yes correct good â€ OK Hand approved U	ğŸ‘Œ	1
A rice ball called onigiri Japanese Â  containing white rice wrapped seaweed called nori Japanase Rice Ball approved  	ğŸ™	1
A small yellow baby chick chicken Baby Chick approved Unicode 6.0 2010 added Emoji 1.0 2015 Copy paste	ğŸ¤	1
A smiling devil like face Â  Has evil looking smiling face inward facing eyebrows In Apple artwork appears purple nearly	ğŸ˜ˆ	1
A bar chart showing comparison figures data Bar Chart approved Unicode 6.0 2010 added Emoji 1.0 2	ğŸ“Š	1
This version Baby Angel emoji Medium dark Skin Tone applied displayed Dark Brown Skin Tone supported  	ğŸ‘¼ğŸ¾	1
An embarrassed face Â  flushed red cheeks Â  This face Â  blushing mistake embarrassing situation In Apple artwork Â  t	ğŸ˜³	1
A large ship transport people cargo ocean May cruise ship commonly found tropical locations Ship w	ğŸš¢	1
A shrine Japanese Shinto religion This emoji generally displays torii gate Shinto Shrine The torii	â›©	1
